rashmika@adsl-dynamic-ipv6:~$ kubectl cluster-info
E0618 08:46:16.257437    3970 memcache.go:265] "Unhandled Error" err="couldn't get current server API group list: Get \"https://192.168.49.2:8443/api?timeout=32s\": dial tcp 192.168.49.2:8443: connect: no route to host"
E0618 08:46:19.326272    3970 memcache.go:265] "Unhandled Error" err="couldn't get current server API group list: Get \"https://192.168.49.2:8443/api?timeout=32s\": dial tcp 192.168.49.2:8443: connect: no route to host"
E0618 08:46:22.398198    3970 memcache.go:265] "Unhandled Error" err="couldn't get current server API group list: Get \"https://192.168.49.2:8443/api?timeout=32s\": dial tcp 192.168.49.2:8443: connect: no route to host"
E0618 08:46:25.469411    3970 memcache.go:265] "Unhandled Error" err="couldn't get current server API group list: Get \"https://192.168.49.2:8443/api?timeout=32s\": dial tcp 192.168.49.2:8443: connect: no route to host"
E0618 08:46:28.542651    3970 memcache.go:265] "Unhandled Error" err="couldn't get current server API group list: Get \"https://192.168.49.2:8443/api?timeout=32s\": dial tcp 192.168.49.2:8443: connect: no route to host"

To further debug and diagnose cluster problems, use 'kubectl cluster-info dump'.
Unable to connect to the server: dial tcp 192.168.49.2:8443: connect: no route to host
rashmika@adsl-dynamic-ipv6:~$ minikube status
minikube
type: Control Plane
host: Stopped
kubelet: Stopped
apiserver: Stopped
kubeconfig: Stopped

rashmika@adsl-dynamic-ipv6:~$ minikube start
😄  minikube v1.36.0 on Fedora 42 (vbox/amd64)
✨  Using the docker driver based on existing profile

🧯  The requested memory allocation of 1900MiB does not leave room for system overhead (total system memory: 2310MiB). You may face stability issues.
💡  Suggestion: Start minikube with less memory allocated: 'minikube start --memory=2200mb'

👍  Starting "minikube" primary control-plane node in "minikube" cluster
🚜  Pulling base image v0.0.47 ...
🔄  Restarting existing docker container for "minikube" ...
🐳  Preparing Kubernetes v1.33.1 on Docker 28.1.1 ...
🔎  Verifying Kubernetes components...
    ▪ Using image gcr.io/k8s-minikube/storage-provisioner:v5
🌟  Enabled addons: storage-provisioner, default-storageclass
🏄  Done! kubectl is now configured to use "minikube" cluster and "default" namespace by default
rashmika@adsl-dynamic-ipv6:~$ minikube status
minikube
type: Control Plane
host: Running
kubelet: Running
apiserver: Running
kubeconfig: Configured

rashmika@adsl-dynamic-ipv6:~$ minikube ip
192.168.49.2
rashmika@adsl-dynamic-ipv6:~$ ping 192.168.49.2
PING 192.168.49.2 (192.168.49.2) 56(84) bytes of data.
64 bytes from 192.168.49.2: icmp_seq=1 ttl=64 time=0.182 ms
64 bytes from 192.168.49.2: icmp_seq=2 ttl=64 time=0.052 ms
64 bytes from 192.168.49.2: icmp_seq=3 ttl=64 time=0.106 ms
64 bytes from 192.168.49.2: icmp_seq=4 ttl=64 time=0.108 ms
64 bytes from 192.168.49.2: icmp_seq=5 ttl=64 time=0.080 ms
64 bytes from 192.168.49.2: icmp_seq=6 ttl=64 time=0.079 ms
64 bytes from 192.168.49.2: icmp_seq=7 ttl=64 time=0.118 ms
64 bytes from 192.168.49.2: icmp_seq=8 ttl=64 time=0.100 ms
64 bytes from 192.168.49.2: icmp_seq=9 ttl=64 time=0.081 ms
64 bytes from 192.168.49.2: icmp_seq=10 ttl=64 time=0.073 ms
64 bytes from 192.168.49.2: icmp_seq=11 ttl=64 time=0.075 ms
64 bytes from 192.168.49.2: icmp_seq=12 ttl=64 time=0.076 ms
64 bytes from 192.168.49.2: icmp_seq=13 ttl=64 time=0.075 ms
64 bytes from 192.168.49.2: icmp_seq=14 ttl=64 time=0.076 ms
64 bytes from 192.168.49.2: icmp_seq=15 ttl=64 time=0.102 ms
64 bytes from 192.168.49.2: icmp_seq=16 ttl=64 time=0.134 ms
64 bytes from 192.168.49.2: icmp_seq=17 ttl=64 time=0.164 ms
^C
--- 192.168.49.2 ping statistics ---
17 packets transmitted, 17 received, 0% packet loss, time 16391ms
rtt min/avg/max/mdev = 0.052/0.098/0.182/0.033 ms
rashmika@adsl-dynamic-ipv6:~$ minikube profile list
|----------|-----------|---------|--------------|------|---------|--------|-------|----------------|--------------------|
| Profile  | VM Driver | Runtime |      IP      | Port | Version | Status | Nodes | Active Profile | Active Kubecontext |
|----------|-----------|---------|--------------|------|---------|--------|-------|----------------|--------------------|
| minikube | docker    | docker  | 192.168.49.2 | 8443 | v1.33.1 | OK     |     1 | *              | *                  |
|----------|-----------|---------|--------------|------|---------|--------|-------|----------------|--------------------|
rashmika@adsl-dynamic-ipv6:~$ kubectl cluster info
error: unknown command "cluster" for "kubectl"

Did you mean this?
	cluster-info
rashmika@adsl-dynamic-ipv6:~$ kubectl cluster-info
Kubernetes control plane is running at https://192.168.49.2:8443
CoreDNS is running at https://192.168.49.2:8443/api/v1/namespaces/kube-system/services/kube-dns:dns/proxy

To further debug and diagnose cluster problems, use 'kubectl cluster-info dump'.
rashmika@adsl-dynamic-ipv6:~$ kubectl get nodes
NAME       STATUS   ROLES           AGE     VERSION
minikube   Ready    control-plane   5d21h   v1.33.1
rashmika@adsl-dynamic-ipv6:~$ kubectl config get-contexts
CURRENT   NAME       CLUSTER    AUTHINFO   NAMESPACE
*         minikube   minikube   minikube   default
rashmika@adsl-dynamic-ipv6:~$ kubectl config current-context
minikube
rashmika@adsl-dynamic-ipv6:~$ kubectl get pods -A
NAMESPACE     NAME                               READY   STATUS    RESTARTS       AGE
default       mybox                              1/1     Running   2 (24m ago)    4d17h
default       mynginx-fb7f4c54-4r2r6             1/1     Running   1 (24m ago)    5d17h
default       mynginx-fb7f4c54-mvvz4             1/1     Running   1 (24m ago)    5d17h
default       mynginx-fb7f4c54-skqpr             1/1     Running   1 (24m ago)    5d17h
kube-system   coredns-674b8bbfcf-2f2jq           1/1     Running   1 (24m ago)    5d21h
kube-system   etcd-minikube                      1/1     Running   1 (24m ago)    5d21h
kube-system   kube-apiserver-minikube            1/1     Running   9 (24m ago)    5d21h
kube-system   kube-controller-manager-minikube   1/1     Running   8 (24m ago)    5d21h
kube-system   kube-proxy-fc9hz                   1/1     Running   1 (24m ago)    5d21h
kube-system   kube-scheduler-minikube            1/1     Running   2 (24m ago)    5d21h
kube-system   storage-provisioner                1/1     Running   30 (22m ago)   5d21h
rashmika@adsl-dynamic-ipv6:~$ kubectx
minikube
rashmika@adsl-dynamic-ipv6:~$ kubectl cluster-info --context kind-kind
error: context "kind-kind" does not exist
rashmika@adsl-dynamic-ipv6:~$ kind version
bash: kind: command not found...
rashmika@adsl-dynamic-ipv6:~$ curl -Lo ./kind https://kind.sigs.k8s.io/dl/latest/kind-linux-amd64
chmod +x ./kind
sudo mv ./kind /usr/local/bin/kind
  % Total    % Received % Xferd  Average Speed   Time    Time     Time  Current
                                 Dload  Upload   Total   Spent    Left  Speed
100    86  100    86    0     0    178      0 --:--:-- --:--:-- --:--:--   178
100 10.5M  100 10.5M    0     0   605k      0  0:00:17  0:00:17 --:--:--  584k
[sudo] password for rashmika: 
rashmika@adsl-dynamic-ipv6:~$ chmod +x ./kind
chmod: cannot access './kind': No such file or directory
rashmika@adsl-dynamic-ipv6:~$ curl -Lo ./kind https://kind.sigs.k8s.io/dl/latest/kind-linux-amd64
  % Total    % Received % Xferd  Average Speed   Time    Time     Time  Current
                                 Dload  Upload   Total   Spent    Left  Speed
100    86  100    86    0     0    177      0 --:--:-- --:--:-- --:--:--   178
100 10.5M  100 10.5M    0     0   600k      0  0:00:17  0:00:17 --:--:--  569k
rashmika@adsl-dynamic-ipv6:~$ chmod +x ./kind
rashmika@adsl-dynamic-ipv6:~$ sudo mv ./kind /usr/local/bin/kind
rashmika@adsl-dynamic-ipv6:~$ kind version
kind v0.30.0-alpha+3df64e784cc0ea go1.24.4 linux/amd64
rashmika@adsl-dynamic-ipv6:~$ kind create cluster
Creating cluster "kind" ...
 ✓ Ensuring node image (kindest/node:v1.33.1) 🖼 
 ✓ Preparing nodes 📦  
 ✓ Writing configuration 📜 
 ✗ Starting control-plane 🕹️ 
Deleted nodes: ["kind-control-plane"]
ERROR: failed to create cluster: failed to init node with kubeadm: command "docker exec --privileged kind-control-plane kubeadm init --config=/kind/kubeadm.conf --skip-token-print --v=6" failed with error: exit status 1
Command Output: I0618 06:03:26.978707     173 initconfiguration.go:261] loading configuration from "/kind/kubeadm.conf"
W0618 06:03:26.997395     173 common.go:101] your configuration file uses a deprecated API spec: "kubeadm.k8s.io/v1beta3" (kind: "ClusterConfiguration"). Please use 'kubeadm config migrate --old-config old-config-file --new-config new-config-file', which will write the new, similar spec using a newer API version.
W0618 06:03:27.011685     173 common.go:101] your configuration file uses a deprecated API spec: "kubeadm.k8s.io/v1beta3" (kind: "InitConfiguration"). Please use 'kubeadm config migrate --old-config old-config-file --new-config new-config-file', which will write the new, similar spec using a newer API version.
W0618 06:03:27.015484     173 common.go:101] your configuration file uses a deprecated API spec: "kubeadm.k8s.io/v1beta3" (kind: "JoinConfiguration"). Please use 'kubeadm config migrate --old-config old-config-file --new-config new-config-file', which will write the new, similar spec using a newer API version.
W0618 06:03:27.016776     173 initconfiguration.go:362] [config] WARNING: Ignored configuration document with GroupVersionKind kubeadm.k8s.io/v1beta3, Kind=JoinConfiguration
[init] Using Kubernetes version: v1.33.1
[certs] Using certificateDir folder "/etc/kubernetes/pki"
I0618 06:03:27.035521     173 certs.go:112] creating a new certificate authority for ca
[certs] Generating "ca" certificate and key
I0618 06:03:32.566804     173 certs.go:473] validating certificate period for ca certificate
[certs] Generating "apiserver" certificate and key
[certs] apiserver serving cert is signed for DNS names [kind-control-plane kubernetes kubernetes.default kubernetes.default.svc kubernetes.default.svc.cluster.local localhost] and IPs [10.96.0.1 172.18.0.2 127.0.0.1]
[certs] Generating "apiserver-kubelet-client" certificate and key
I0618 06:03:56.902631     173 certs.go:112] creating a new certificate authority for front-proxy-ca
[certs] Generating "front-proxy-ca" certificate and key
I0618 06:03:59.351898     173 certs.go:473] validating certificate period for front-proxy-ca certificate
[certs] Generating "front-proxy-client" certificate and key
I0618 06:04:01.542686     173 certs.go:112] creating a new certificate authority for etcd-ca
[certs] Generating "etcd/ca" certificate and key
I0618 06:04:05.372973     173 certs.go:473] validating certificate period for etcd/ca certificate
[certs] Generating "etcd/server" certificate and key
[certs] etcd/server serving cert is signed for DNS names [kind-control-plane localhost] and IPs [172.18.0.2 127.0.0.1 ::1]
[certs] Generating "etcd/peer" certificate and key
[certs] etcd/peer serving cert is signed for DNS names [kind-control-plane localhost] and IPs [172.18.0.2 127.0.0.1 ::1]
[certs] Generating "etcd/healthcheck-client" certificate and key
[certs] Generating "apiserver-etcd-client" certificate and key
I0618 06:04:13.465430     173 certs.go:78] creating new public/private key files for signing service account users
[certs] Generating "sa" key and public key
[kubeconfig] Using kubeconfig folder "/etc/kubernetes"
I0618 06:04:19.099064     173 kubeconfig.go:111] creating kubeconfig file for admin.conf
[kubeconfig] Writing "admin.conf" kubeconfig file
I0618 06:04:28.445771     173 kubeconfig.go:111] creating kubeconfig file for super-admin.conf
[kubeconfig] Writing "super-admin.conf" kubeconfig file
I0618 06:04:29.219300     173 kubeconfig.go:111] creating kubeconfig file for kubelet.conf
[kubeconfig] Writing "kubelet.conf" kubeconfig file
I0618 06:04:32.593249     173 kubeconfig.go:111] creating kubeconfig file for controller-manager.conf
[kubeconfig] Writing "controller-manager.conf" kubeconfig file
I0618 06:04:53.250123     173 kubeconfig.go:111] creating kubeconfig file for scheduler.conf
[kubeconfig] Writing "scheduler.conf" kubeconfig file
[etcd] Creating static Pod manifest for local etcd in "/etc/kubernetes/manifests"
I0618 06:05:00.026621     173 local.go:66] [etcd] wrote Static Pod manifest for a local etcd member to "/etc/kubernetes/manifests/etcd.yaml"
I0618 06:05:00.028997     173 manifests.go:104] [control-plane] getting StaticPodSpecs
[control-plane] Using manifest folder "/etc/kubernetes/manifests"
[control-plane] Creating static Pod manifest for "kube-apiserver"
I0618 06:05:00.098407     173 certs.go:473] validating certificate period for CA certificate
I0618 06:05:00.107115     173 manifests.go:130] [control-plane] adding volume "ca-certs" for component "kube-apiserver"
I0618 06:05:00.107190     173 manifests.go:130] [control-plane] adding volume "etc-ca-certificates" for component "kube-apiserver"
I0618 06:05:00.107240     173 manifests.go:130] [control-plane] adding volume "k8s-certs" for component "kube-apiserver"
I0618 06:05:00.107321     173 manifests.go:130] [control-plane] adding volume "usr-local-share-ca-certificates" for component "kube-apiserver"
I0618 06:05:00.107392     173 manifests.go:130] [control-plane] adding volume "usr-share-ca-certificates" for component "kube-apiserver"
I0618 06:05:00.172662     173 manifests.go:159] [control-plane] wrote static Pod manifest for component "kube-apiserver" to "/etc/kubernetes/manifests/kube-apiserver.yaml"
[control-plane] Creating static Pod manifest for "kube-controller-manager"
I0618 06:05:00.177483     173 manifests.go:104] [control-plane] getting StaticPodSpecs
I0618 06:05:00.178129     173 manifests.go:130] [control-plane] adding volume "ca-certs" for component "kube-controller-manager"
[control-plane] Creating static Pod manifest for "kube-scheduler"
I0618 06:05:00.185577     173 manifests.go:130] [control-plane] adding volume "etc-ca-certificates" for component "kube-controller-manager"
I0618 06:05:00.185785     173 manifests.go:130] [control-plane] adding volume "flexvolume-dir" for component "kube-controller-manager"
I0618 06:05:00.185856     173 manifests.go:130] [control-plane] adding volume "k8s-certs" for component "kube-controller-manager"
I0618 06:05:00.185874     173 manifests.go:130] [control-plane] adding volume "kubeconfig" for component "kube-controller-manager"
I0618 06:05:00.185961     173 manifests.go:130] [control-plane] adding volume "usr-local-share-ca-certificates" for component "kube-controller-manager"
I0618 06:05:00.185979     173 manifests.go:130] [control-plane] adding volume "usr-share-ca-certificates" for component "kube-controller-manager"
I0618 06:05:00.190536     173 manifests.go:159] [control-plane] wrote static Pod manifest for component "kube-controller-manager" to "/etc/kubernetes/manifests/kube-controller-manager.yaml"
I0618 06:05:00.190620     173 manifests.go:104] [control-plane] getting StaticPodSpecs
I0618 06:05:00.192135     173 manifests.go:130] [control-plane] adding volume "kubeconfig" for component "kube-scheduler"
I0618 06:05:00.347846     173 manifests.go:159] [control-plane] wrote static Pod manifest for component "kube-scheduler" to "/etc/kubernetes/manifests/kube-scheduler.yaml"
I0618 06:05:00.347980     173 kubelet.go:70] Stopping the kubelet
[kubelet-start] Writing kubelet environment file with flags to file "/var/lib/kubelet/kubeadm-flags.env"
[kubelet-start] Writing kubelet configuration to file "/var/lib/kubelet/config.yaml"
[kubelet-start] Starting the kubelet
I0618 06:05:07.894713     173 loader.go:402] Config loaded from file:  /etc/kubernetes/admin.conf
I0618 06:05:08.290800     173 envvar.go:172] "Feature gate default state" feature="ClientsAllowCBOR" enabled=false
I0618 06:05:08.309369     173 envvar.go:172] "Feature gate default state" feature="ClientsPreferCBOR" enabled=false
I0618 06:05:08.309466     173 envvar.go:172] "Feature gate default state" feature="InformerResourceVersion" enabled=false
I0618 06:05:08.309515     173 envvar.go:172] "Feature gate default state" feature="InOrderInformers" enabled=true
I0618 06:05:08.309559     173 envvar.go:172] "Feature gate default state" feature="WatchListClient" enabled=false
[wait-control-plane] Waiting for the kubelet to boot up the control plane as static Pods from directory "/etc/kubernetes/manifests"
[kubelet-check] Waiting for a healthy kubelet at http://127.0.0.1:10248/healthz. This can take up to 4m0s
[kubelet-check] The kubelet is healthy after 40.858433397s
[control-plane-check] Waiting for healthy control plane components. This can take up to 4m0s
[control-plane-check] Checking kube-apiserver at https://172.18.0.2:6443/livez
[control-plane-check] Checking kube-controller-manager at https://127.0.0.1:10257/healthz
[control-plane-check] Checking kube-scheduler at https://127.0.0.1:10259/livez
I0618 06:05:49.924238     173 round_trippers.go:632] "Response" verb="GET" url="https://kind-control-plane:6443/livez?timeout=10s" status="" milliseconds=110
I0618 06:05:50.308289     173 round_trippers.go:632] "Response" verb="GET" url="https://kind-control-plane:6443/livez?timeout=10s" status="" milliseconds=9
I0618 06:05:50.817401     173 round_trippers.go:632] "Response" verb="GET" url="https://kind-control-plane:6443/livez?timeout=10s" status="" milliseconds=5
I0618 06:05:51.302287     173 round_trippers.go:632] "Response" verb="GET" url="https://kind-control-plane:6443/livez?timeout=10s" status="" milliseconds=2
I0618 06:05:51.801149     173 round_trippers.go:632] "Response" verb="GET" url="https://kind-control-plane:6443/livez?timeout=10s" status="" milliseconds=0
I0618 06:05:52.300170     173 round_trippers.go:632] "Response" verb="GET" url="https://kind-control-plane:6443/livez?timeout=10s" status="" milliseconds=0
I0618 06:05:52.860821     173 round_trippers.go:632] "Response" verb="GET" url="https://kind-control-plane:6443/livez?timeout=10s" status="" milliseconds=32
I0618 06:05:53.303038     173 round_trippers.go:632] "Response" verb="GET" url="https://kind-control-plane:6443/livez?timeout=10s" status="" milliseconds=1
I0618 06:05:53.827297     173 round_trippers.go:632] "Response" verb="GET" url="https://kind-control-plane:6443/livez?timeout=10s" status="" milliseconds=17
I0618 06:05:54.435660     173 round_trippers.go:632] "Response" verb="GET" url="https://kind-control-plane:6443/livez?timeout=10s" status="" milliseconds=11
I0618 06:05:54.831252     173 round_trippers.go:632] "Response" verb="GET" url="https://kind-control-plane:6443/livez?timeout=10s" status="" milliseconds=5
I0618 06:05:55.725111     173 round_trippers.go:632] "Response" verb="GET" url="https://kind-control-plane:6443/livez?timeout=10s" status="" milliseconds=419
I0618 06:05:55.801611     173 round_trippers.go:632] "Response" verb="GET" url="https://kind-control-plane:6443/livez?timeout=10s" status="" milliseconds=0
I0618 06:05:56.343574     173 round_trippers.go:632] "Response" verb="GET" url="https://kind-control-plane:6443/livez?timeout=10s" status="" milliseconds=3
I0618 06:05:56.944102     173 round_trippers.go:632] "Response" verb="GET" url="https://kind-control-plane:6443/livez?timeout=10s" status="" milliseconds=143
I0618 06:05:57.369762     173 round_trippers.go:632] "Response" verb="GET" url="https://kind-control-plane:6443/livez?timeout=10s" status="" milliseconds=18
I0618 06:05:57.802872     173 round_trippers.go:632] "Response" verb="GET" url="https://kind-control-plane:6443/livez?timeout=10s" status="" milliseconds=3
I0618 06:05:58.336525     173 round_trippers.go:632] "Response" verb="GET" url="https://kind-control-plane:6443/livez?timeout=10s" status="" milliseconds=4
I0618 06:05:58.803956     173 round_trippers.go:632] "Response" verb="GET" url="https://kind-control-plane:6443/livez?timeout=10s" status="" milliseconds=1
I0618 06:05:59.308361     173 round_trippers.go:632] "Response" verb="GET" url="https://kind-control-plane:6443/livez?timeout=10s" status="" milliseconds=1
I0618 06:05:59.803091     173 round_trippers.go:632] "Response" verb="GET" url="https://kind-control-plane:6443/livez?timeout=10s" status="" milliseconds=2
I0618 06:06:00.300693     173 round_trippers.go:632] "Response" verb="GET" url="https://kind-control-plane:6443/livez?timeout=10s" status="" milliseconds=1
I0618 06:06:00.814312     173 round_trippers.go:632] "Response" verb="GET" url="https://kind-control-plane:6443/livez?timeout=10s" status="" milliseconds=5
I0618 06:06:01.325188     173 round_trippers.go:632] "Response" verb="GET" url="https://kind-control-plane:6443/livez?timeout=10s" status="" milliseconds=1
I0618 06:06:01.809246     173 round_trippers.go:632] "Response" verb="GET" url="https://kind-control-plane:6443/livez?timeout=10s" status="" milliseconds=7
I0618 06:06:02.307479     173 round_trippers.go:632] "Response" verb="GET" url="https://kind-control-plane:6443/livez?timeout=10s" status="" milliseconds=7
I0618 06:06:02.801068     173 round_trippers.go:632] "Response" verb="GET" url="https://kind-control-plane:6443/livez?timeout=10s" status="" milliseconds=1
I0618 06:06:03.299912     173 round_trippers.go:632] "Response" verb="GET" url="https://kind-control-plane:6443/livez?timeout=10s" status="" milliseconds=0
I0618 06:06:03.801505     173 round_trippers.go:632] "Response" verb="GET" url="https://kind-control-plane:6443/livez?timeout=10s" status="" milliseconds=1
I0618 06:06:04.327684     173 round_trippers.go:632] "Response" verb="GET" url="https://kind-control-plane:6443/livez?timeout=10s" status="" milliseconds=4
I0618 06:06:04.802317     173 round_trippers.go:632] "Response" verb="GET" url="https://kind-control-plane:6443/livez?timeout=10s" status="" milliseconds=2
I0618 06:06:05.300822     173 round_trippers.go:632] "Response" verb="GET" url="https://kind-control-plane:6443/livez?timeout=10s" status="" milliseconds=0
I0618 06:06:05.800407     173 round_trippers.go:632] "Response" verb="GET" url="https://kind-control-plane:6443/livez?timeout=10s" status="" milliseconds=0
I0618 06:06:06.302175     173 round_trippers.go:632] "Response" verb="GET" url="https://kind-control-plane:6443/livez?timeout=10s" status="" milliseconds=2
I0618 06:06:06.801551     173 round_trippers.go:632] "Response" verb="GET" url="https://kind-control-plane:6443/livez?timeout=10s" status="" milliseconds=1
I0618 06:06:07.526160     173 round_trippers.go:632] "Response" verb="GET" url="https://kind-control-plane:6443/livez?timeout=10s" status="" milliseconds=226
I0618 06:06:07.800985     173 round_trippers.go:632] "Response" verb="GET" url="https://kind-control-plane:6443/livez?timeout=10s" status="" milliseconds=1
I0618 06:06:08.302280     173 round_trippers.go:632] "Response" verb="GET" url="https://kind-control-plane:6443/livez?timeout=10s" status="" milliseconds=0
I0618 06:06:08.804595     173 round_trippers.go:632] "Response" verb="GET" url="https://kind-control-plane:6443/livez?timeout=10s" status="" milliseconds=2
I0618 06:06:09.322208     173 round_trippers.go:632] "Response" verb="GET" url="https://kind-control-plane:6443/livez?timeout=10s" status="" milliseconds=22
I0618 06:06:09.804373     173 round_trippers.go:632] "Response" verb="GET" url="https://kind-control-plane:6443/livez?timeout=10s" status="" milliseconds=5
I0618 06:06:10.313783     173 round_trippers.go:632] "Response" verb="GET" url="https://kind-control-plane:6443/livez?timeout=10s" status="" milliseconds=12
I0618 06:06:10.800729     173 round_trippers.go:632] "Response" verb="GET" url="https://kind-control-plane:6443/livez?timeout=10s" status="" milliseconds=0
I0618 06:06:11.361603     173 round_trippers.go:632] "Response" verb="GET" url="https://kind-control-plane:6443/livez?timeout=10s" status="" milliseconds=60
I0618 06:06:11.809001     173 round_trippers.go:632] "Response" verb="GET" url="https://kind-control-plane:6443/livez?timeout=10s" status="" milliseconds=9
I0618 06:06:12.316282     173 round_trippers.go:632] "Response" verb="GET" url="https://kind-control-plane:6443/livez?timeout=10s" status="" milliseconds=1
I0618 06:06:12.801714     173 round_trippers.go:632] "Response" verb="GET" url="https://kind-control-plane:6443/livez?timeout=10s" status="" milliseconds=1
I0618 06:06:13.379539     173 round_trippers.go:632] "Response" verb="GET" url="https://kind-control-plane:6443/livez?timeout=10s" status="" milliseconds=29
I0618 06:06:13.807576     173 round_trippers.go:632] "Response" verb="GET" url="https://kind-control-plane:6443/livez?timeout=10s" status="" milliseconds=4
I0618 06:06:14.346912     173 round_trippers.go:632] "Response" verb="GET" url="https://kind-control-plane:6443/livez?timeout=10s" status="" milliseconds=5
I0618 06:06:14.855627     173 round_trippers.go:632] "Response" verb="GET" url="https://kind-control-plane:6443/livez?timeout=10s" status="" milliseconds=1
I0618 06:06:15.307255     173 round_trippers.go:632] "Response" verb="GET" url="https://kind-control-plane:6443/livez?timeout=10s" status="" milliseconds=0
I0618 06:06:15.801236     173 round_trippers.go:632] "Response" verb="GET" url="https://kind-control-plane:6443/livez?timeout=10s" status="" milliseconds=1
I0618 06:06:16.300380     173 round_trippers.go:632] "Response" verb="GET" url="https://kind-control-plane:6443/livez?timeout=10s" status="" milliseconds=1
I0618 06:06:16.816184     173 round_trippers.go:632] "Response" verb="GET" url="https://kind-control-plane:6443/livez?timeout=10s" status="" milliseconds=15
I0618 06:06:17.300271     173 round_trippers.go:632] "Response" verb="GET" url="https://kind-control-plane:6443/livez?timeout=10s" status="" milliseconds=0
I0618 06:06:17.816959     173 round_trippers.go:632] "Response" verb="GET" url="https://kind-control-plane:6443/livez?timeout=10s" status="" milliseconds=0
I0618 06:06:18.306900     173 round_trippers.go:632] "Response" verb="GET" url="https://kind-control-plane:6443/livez?timeout=10s" status="" milliseconds=1
I0618 06:06:18.924469     173 round_trippers.go:632] "Response" verb="GET" url="https://kind-control-plane:6443/livez?timeout=10s" status="" milliseconds=114
I0618 06:06:19.302041     173 round_trippers.go:632] "Response" verb="GET" url="https://kind-control-plane:6443/livez?timeout=10s" status="" milliseconds=2
I0618 06:06:19.801558     173 round_trippers.go:632] "Response" verb="GET" url="https://kind-control-plane:6443/livez?timeout=10s" status="" milliseconds=1
I0618 06:06:20.303563     173 round_trippers.go:632] "Response" verb="GET" url="https://kind-control-plane:6443/livez?timeout=10s" status="" milliseconds=3
I0618 06:06:20.801371     173 round_trippers.go:632] "Response" verb="GET" url="https://kind-control-plane:6443/livez?timeout=10s" status="" milliseconds=0
I0618 06:06:21.357279     173 round_trippers.go:632] "Response" verb="GET" url="https://kind-control-plane:6443/livez?timeout=10s" status="" milliseconds=0
I0618 06:06:22.034171     173 round_trippers.go:632] "Response" verb="GET" url="https://kind-control-plane:6443/livez?timeout=10s" status="" milliseconds=82
I0618 06:06:22.300833     173 round_trippers.go:632] "Response" verb="GET" url="https://kind-control-plane:6443/livez?timeout=10s" status="" milliseconds=0
I0618 06:06:22.803179     173 round_trippers.go:632] "Response" verb="GET" url="https://kind-control-plane:6443/livez?timeout=10s" status="" milliseconds=3
I0618 06:06:23.412348     173 round_trippers.go:632] "Response" verb="GET" url="https://kind-control-plane:6443/livez?timeout=10s" status="" milliseconds=107

I0618 06:08:40.674553     173 round_trippers.go:632] "Response" verb="GET" url="https://kind-control-plane:6443/livez?timeout=10s" status="" milliseconds=11259
[control-plane-check] kube-controller-manager is healthy after 3m0.168673692s
I0618 06:08:51.566237     173 round_trippers.go:632] "Response" verb="GET" url="https://kind-control-plane:6443/livez?timeout=10s" status="" milliseconds=9996
I0618 06:09:03.522102     173 round_trippers.go:632] "Response" verb="GET" url="https://kind-control-plane:6443/livez?timeout=10s" status="" milliseconds=9998
[control-plane-check] kube-scheduler is healthy after 3m17.795157896s
I0618 06:09:15.727745     173 round_trippers.go:632] "Response" verb="GET" url="https://kind-control-plane:6443/livez?timeout=10s" status="" milliseconds=10038
I0618 06:09:26.529950     173 round_trippers.go:632] "Response" verb="GET" url="https://kind-control-plane:6443/livez?timeout=10s" status="" milliseconds=10204
I0618 06:09:40.088963     173 round_trippers.go:632] "Response" verb="GET" url="https://kind-control-plane:6443/livez?timeout=10s" status="" milliseconds=10777
[control-plane-check] kube-apiserver is not healthy after 4m1.879570004s

A control plane component may have crashed or exited when started by the container runtime.
To troubleshoot, list all containers using your preferred container runtimes CLI.
Here is one example how you may list all running Kubernetes containers by using crictl:
	- 'crictl --runtime-endpoint unix:///run/containerd/containerd.sock ps -a | grep kube | grep -v pause'
	Once you have found the failing container, you can inspect its logs with:
	- 'crictl --runtime-endpoint unix:///run/containerd/containerd.sock logs CONTAINERID'

I0618 06:09:51.515928     173 round_trippers.go:632] "Response" verb="GET" url="https://kind-control-plane:6443/livez?timeout=10s" status="" milliseconds=9964
kube-apiserver check failed at https://172.18.0.2:6443/livez: Get "https://kind-control-plane:6443/livez?timeout=10s": context deadline exceeded (Client.Timeout exceeded while awaiting headers)
failed while waiting for the control plane to start
k8s.io/kubernetes/cmd/kubeadm/app/cmd/phases/init.runWaitControlPlanePhase
	k8s.io/kubernetes/cmd/kubeadm/app/cmd/phases/init/waitcontrolplane.go:106
k8s.io/kubernetes/cmd/kubeadm/app/cmd/phases/workflow.(*Runner).Run.func1
	k8s.io/kubernetes/cmd/kubeadm/app/cmd/phases/workflow/runner.go:261
k8s.io/kubernetes/cmd/kubeadm/app/cmd/phases/workflow.(*Runner).visitAll
	k8s.io/kubernetes/cmd/kubeadm/app/cmd/phases/workflow/runner.go:450
k8s.io/kubernetes/cmd/kubeadm/app/cmd/phases/workflow.(*Runner).Run
	k8s.io/kubernetes/cmd/kubeadm/app/cmd/phases/workflow/runner.go:234
k8s.io/kubernetes/cmd/kubeadm/app/cmd.newCmdInit.func1
	k8s.io/kubernetes/cmd/kubeadm/app/cmd/init.go:132
github.com/spf13/cobra.(*Command).execute
	github.com/spf13/cobra@v1.8.1/command.go:985
github.com/spf13/cobra.(*Command).ExecuteC
	github.com/spf13/cobra@v1.8.1/command.go:1117
github.com/spf13/cobra.(*Command).Execute
	github.com/spf13/cobra@v1.8.1/command.go:1041
k8s.io/kubernetes/cmd/kubeadm/app.Run
	k8s.io/kubernetes/cmd/kubeadm/app/kubeadm.go:47
main.main
	k8s.io/kubernetes/cmd/kubeadm/kubeadm.go:25
runtime.main
	runtime/proc.go:283
runtime.goexit
	runtime/asm_amd64.s:1700
error execution phase wait-control-plane
k8s.io/kubernetes/cmd/kubeadm/app/cmd/phases/workflow.(*Runner).Run.func1
	k8s.io/kubernetes/cmd/kubeadm/app/cmd/phases/workflow/runner.go:262
k8s.io/kubernetes/cmd/kubeadm/app/cmd/phases/workflow.(*Runner).visitAll
	k8s.io/kubernetes/cmd/kubeadm/app/cmd/phases/workflow/runner.go:450
k8s.io/kubernetes/cmd/kubeadm/app/cmd/phases/workflow.(*Runner).Run
	k8s.io/kubernetes/cmd/kubeadm/app/cmd/phases/workflow/runner.go:234
k8s.io/kubernetes/cmd/kubeadm/app/cmd.newCmdInit.func1
	k8s.io/kubernetes/cmd/kubeadm/app/cmd/init.go:132
github.com/spf13/cobra.(*Command).execute
	github.com/spf13/cobra@v1.8.1/command.go:985
github.com/spf13/cobra.(*Command).ExecuteC
	github.com/spf13/cobra@v1.8.1/command.go:1117
github.com/spf13/cobra.(*Command).Execute
	github.com/spf13/cobra@v1.8.1/command.go:1041
k8s.io/kubernetes/cmd/kubeadm/app.Run
	k8s.io/kubernetes/cmd/kubeadm/app/kubeadm.go:47
main.main
	k8s.io/kubernetes/cmd/kubeadm/kubeadm.go:25
runtime.main
	runtime/proc.go:283
runtime.goexit
	runtime/asm_amd64.s:1700
rashmika@adsl-dynamic-ipv6:~$ kind create cluster --image kindest/node:v1.29.2
Creating cluster "kind" ...
 ✓ Ensuring node image (kindest/node:v1.29.2) 🖼 
 ✓ Preparing nodes 📦  
 ✓ Writing configuration 📜 
 ✓ Starting control-plane 🕹️ 
 ✓ Installing CNI 🔌 
 ✓ Installing StorageClass 💾 
Set kubectl context to "kind-kind"
You can now use your cluster with:

kubectl cluster-info --context kind-kind

Thanks for using kind! 😊
rashmika@adsl-dynamic-ipv6:~$ kubectl config get-contexts 
CURRENT   NAME        CLUSTER     AUTHINFO    NAMESPACE
*         kind-kind   kind-kind   kind-kind   
          minikube    minikube    minikube    default
rashmika@adsl-dynamic-ipv6:~$ kubectl get nodes
NAME                 STATUS   ROLES           AGE     VERSION
kind-control-plane   Ready    control-plane   5m37s   v1.29.2
rashmika@adsl-dynamic-ipv6:~$ su
Password: 
su: Authentication failure
rashmika@adsl-dynamic-ipv6:~$ sudo su
[sudo] password for rashmika: 
root@adsl-dynamic-ipv6:/home/rashmika# ll
total 188432
drwxr-xr-x. 1 rashmika rashmika         0 May 29 11:20 Desktop
drwxr-xr-x. 1 rashmika rashmika        46 Jun  9 12:31 Documents
drwxr-xr-x. 1 rashmika rashmika       104 Jun  2 10:00 Downloads
-rw-r--r--. 1 root     root      60121272 Jun 12 11:42 kubectl
-rw-r--r--. 1 rashmika rashmika     10174 Apr 20  2024 LICENSE
drwxr-xr-x. 1 rashmika rashmika         0 Jun  2 11:55 Media
-rw-r--r--. 1 root     root     132766301 Jun 11 16:45 minikube-linux-amd64
drwxr-xr-x. 1 rashmika rashmika         0 May 29 11:20 Music
drwxr-xr-x. 1 rashmika rashmika         0 May 29 11:20 Pictures
drwxr-xr-x. 1 rashmika rashmika         0 May 29 11:20 Public
-rw-r--r--. 1 rashmika rashmika     49052 Apr 19 23:37 README.md
drwxr-xr-x. 1 rashmika rashmika         0 May 29 11:20 Templates
drwxr-xr-x. 1 rashmika rashmika         0 May 29 11:20 Videos
root@adsl-dynamic-ipv6:/home/rashmika# cd Documents
root@adsl-dynamic-ipv6:/home/rashmika/Documents# ll
total 0
drwxr-xr-x. 1 rashmika rashmika 130 Jun  3 16:46 PFX_Certificate
drwxr-xr-x. 1 root     root      82 Jun 11 10:09 testdata
root@adsl-dynamic-ipv6:/home/rashmika/Documents# mkdir My_K8s_Projects
root@adsl-dynamic-ipv6:/home/rashmika/Documents# ll
total 0
drwxr-xr-x. 1 root     root       0 Jun 18 13:13 My_K8s_Projects
drwxr-xr-x. 1 rashmika rashmika 130 Jun  3 16:46 PFX_Certificate
drwxr-xr-x. 1 root     root      82 Jun 11 10:09 testdata
root@adsl-dynamic-ipv6:/home/rashmika/Documents# cd My_K8s_Projects
root@adsl-dynamic-ipv6:/home/rashmika/Documents/My_K8s_Projects# mkdir Pods
root@adsl-dynamic-ipv6:/home/rashmika/Documents/My_K8s_Projects# mkkdir deployments
bash: mkkdir: command not found...
Similar command is: 'mkdir'
root@adsl-dynamic-ipv6:/home/rashmika/Documents/My_K8s_Projects# mkdir deployments
root@adsl-dynamic-ipv6:/home/rashmika/Documents/My_K8s_Projects# mkdir services
root@adsl-dynamic-ipv6:/home/rashmika/Documents/My_K8s_Projects# mkdir configmaps
root@adsl-dynamic-ipv6:/home/rashmika/Documents/My_K8s_Projects# mkdir secrets
root@adsl-dynamic-ipv6:/home/rashmika/Documents/My_K8s_Projects# mkdir namespaces
root@adsl-dynamic-ipv6:/home/rashmika/Documents/My_K8s_Projects# rmdir Pods
root@adsl-dynamic-ipv6:/home/rashmika/Documents/My_K8s_Projects# mkdir pods
root@adsl-dynamic-ipv6:/home/rashmika/Documents/My_K8s_Projects# ll
total 0
drwxr-xr-x. 1 root root 0 Jun 18 13:15 configmaps
drwxr-xr-x. 1 root root 0 Jun 18 13:15 deployments
drwxr-xr-x. 1 root root 0 Jun 18 13:16 namespaces
drwxr-xr-x. 1 root root 0 Jun 18 13:17 pods
drwxr-xr-x. 1 root root 0 Jun 18 13:16 secrets
drwxr-xr-x. 1 root root 0 Jun 18 13:15 services
root@adsl-dynamic-ipv6:/home/rashmika/Documents/My_K8s_Projects# kubectl create deployment nginx
error: required flag(s) "image" not set
root@adsl-dynamic-ipv6:/home/rashmika/Documents/My_K8s_Projects# kubectl create deployment nginx_deploy --image=nginx --port=80 --replicas=3 --dry-run-client -o yaml > /home/rashmika/Documents/My_K8s_Projects/deployments/
bash: /home/rashmika/Documents/My_K8s_Projects/deployments/: Is a directory
root@adsl-dynamic-ipv6:/home/rashmika/Documents/My_K8s_Projects# kubectl create deployment nginx_deploy --image=nginx --port=80 --replicas=3 --dry-run-client -o yaml 
error: unknown flag: --dry-run-client
See 'kubectl create deployment --help' for usage.
root@adsl-dynamic-ipv6:/home/rashmika/Documents/My_K8s_Projects# kubectl create deployment nginx_deploy --image=nginx --port=80 --replicas=3 --dry-run=client -o yaml 

apiVersion: apps/v1
kind: Deployment
metadata:
  creationTimestamp: null
  labels:
    app: nginx_deploy
  name: nginx_deploy
spec:
  replicas: 3
  selector:
    matchLabels:
      app: nginx_deploy
  strategy: {}
  template:
    metadata:
      creationTimestamp: null
      labels:
        app: nginx_deploy
    spec:
      containers:
      - image: nginx
        name: nginx
        ports:
        - containerPort: 80
        resources: {}
status: {}
root@adsl-dynamic-ipv6:/home/rashmika/Documents/My_K8s_Projects# 
root@adsl-dynamic-ipv6:/home/rashmika/Documents/My_K8s_Projects# cddeployments
bash: cddeployments: command not found...
^[[A^C
root@adsl-dynamic-ipv6:/home/rashmika/Documents/My_K8s_Projects# cd deployments
root@adsl-dynamic-ipv6:/home/rashmika/Documents/My_K8s_Projects/deployments# ll
total 0
root@adsl-dynamic-ipv6:/home/rashmika/Documents/My_K8s_Projects/deployments# cd ..
root@adsl-dynamic-ipv6:/home/rashmika/Documents/My_K8s_Projects# ll
total 0
drwxr-xr-x. 1 root root 0 Jun 18 13:15 configmaps
drwxr-xr-x. 1 root root 0 Jun 18 13:15 deployments
drwxr-xr-x. 1 root root 0 Jun 18 13:16 namespaces
drwxr-xr-x. 1 root root 0 Jun 18 13:17 pods
drwxr-xr-x. 1 root root 0 Jun 18 13:16 secrets
drwxr-xr-x. 1 root root 0 Jun 18 13:15 services
root@adsl-dynamic-ipv6:/home/rashmika/Documents/My_K8s_Projects# kubectl create deployment nginx_deploy --image=nginx --port=80 --replicas=3 --dry-run=client -o yaml > nginx_deploy.yaml
root@adsl-dynamic-ipv6:/home/rashmika/Documents/My_K8s_Projects# ll
total 4
drwxr-xr-x. 1 root root   0 Jun 18 13:15 configmaps
drwxr-xr-x. 1 root root   0 Jun 18 13:15 deployments
drwxr-xr-x. 1 root root   0 Jun 18 13:16 namespaces
-rw-r--r--. 1 root root 455 Jun 18 13:35 nginx_deploy.yaml
drwxr-xr-x. 1 root root   0 Jun 18 13:17 pods
drwxr-xr-x. 1 root root   0 Jun 18 13:16 secrets
drwxr-xr-x. 1 root root   0 Jun 18 13:15 services
root@adsl-dynamic-ipv6:/home/rashmika/Documents/My_K8s_Projects# mv nginx_deploy.yaml deployments
root@adsl-dynamic-ipv6:/home/rashmika/Documents/My_K8s_Projects# ll
total 0
drwxr-xr-x. 1 root root  0 Jun 18 13:15 configmaps
drwxr-xr-x. 1 root root 34 Jun 18 13:36 deployments
drwxr-xr-x. 1 root root  0 Jun 18 13:16 namespaces
drwxr-xr-x. 1 root root  0 Jun 18 13:17 pods
drwxr-xr-x. 1 root root  0 Jun 18 13:16 secrets
drwxr-xr-x. 1 root root  0 Jun 18 13:15 services
root@adsl-dynamic-ipv6:/home/rashmika/Documents/My_K8s_Projects# cd deployments
root@adsl-dynamic-ipv6:/home/rashmika/Documents/My_K8s_Projects/deployments# ll
total 4
-rw-r--r--. 1 root root 455 Jun 18 13:35 nginx_deploy.yaml
root@adsl-dynamic-ipv6:/home/rashmika/Documents/My_K8s_Projects/deployments# nano nginx_deploy.yaml
root@adsl-dynamic-ipv6:/home/rashmika/Documents/My_K8s_Projects/deployments# kubectl cluster-info
E0618 13:38:33.382487   79679 memcache.go:265] "Unhandled Error" err="couldn't get current server API group list: Get \"http://localhost:8080/api?timeout=32s\": dial tcp [::1]:8080: connect: connection refused"
E0618 13:38:33.386546   79679 memcache.go:265] "Unhandled Error" err="couldn't get current server API group list: Get \"http://localhost:8080/api?timeout=32s\": dial tcp [::1]:8080: connect: connection refused"
E0618 13:38:33.389989   79679 memcache.go:265] "Unhandled Error" err="couldn't get current server API group list: Get \"http://localhost:8080/api?timeout=32s\": dial tcp [::1]:8080: connect: connection refused"
E0618 13:38:33.420517   79679 memcache.go:265] "Unhandled Error" err="couldn't get current server API group list: Get \"http://localhost:8080/api?timeout=32s\": dial tcp [::1]:8080: connect: connection refused"
E0618 13:38:33.422924   79679 memcache.go:265] "Unhandled Error" err="couldn't get current server API group list: Get \"http://localhost:8080/api?timeout=32s\": dial tcp [::1]:8080: connect: connection refused"

To further debug and diagnose cluster problems, use 'kubectl cluster-info dump'.
The connection to the server localhost:8080 was refused - did you specify the right host or port?
root@adsl-dynamic-ipv6:/home/rashmika/Documents/My_K8s_Projects/deployments# kubectl config get-contexts
CURRENT   NAME   CLUSTER   AUTHINFO   NAMESPACE
root@adsl-dynamic-ipv6:/home/rashmika/Documents/My_K8s_Projects/deployments# kind start
ERROR: unknown command "start" for "kind"
root@adsl-dynamic-ipv6:/home/rashmika/Documents/My_K8s_Projects/deployments# sudo kubectl cluster-info
E0618 13:41:41.647481   80331 memcache.go:265] "Unhandled Error" err="couldn't get current server API group list: Get \"http://localhost:8080/api?timeout=32s\": dial tcp [::1]:8080: connect: connection refused"
E0618 13:41:41.666970   80331 memcache.go:265] "Unhandled Error" err="couldn't get current server API group list: Get \"http://localhost:8080/api?timeout=32s\": dial tcp [::1]:8080: connect: connection refused"
E0618 13:41:41.670126   80331 memcache.go:265] "Unhandled Error" err="couldn't get current server API group list: Get \"http://localhost:8080/api?timeout=32s\": dial tcp [::1]:8080: connect: connection refused"
E0618 13:41:41.674188   80331 memcache.go:265] "Unhandled Error" err="couldn't get current server API group list: Get \"http://localhost:8080/api?timeout=32s\": dial tcp [::1]:8080: connect: connection refused"
E0618 13:41:41.679034   80331 memcache.go:265] "Unhandled Error" err="couldn't get current server API group list: Get \"http://localhost:8080/api?timeout=32s\": dial tcp [::1]:8080: connect: connection refused"

To further debug and diagnose cluster problems, use 'kubectl cluster-info dump'.
The connection to the server localhost:8080 was refused - did you specify the right host or port?
root@adsl-dynamic-ipv6:/home/rashmika/Documents/My_K8s_Projects/deployments# sudo kubectl config get-contexts
CURRENT   NAME   CLUSTER   AUTHINFO   NAMESPACE
root@adsl-dynamic-ipv6:/home/rashmika/Documents/My_K8s_Projects/deployments# minikube start
😄  minikube v1.36.0 on Fedora 42 (vbox/amd64)
✨  Automatically selected the podman driver. Other choices: qemu2, none, ssh
🛑  The "podman" driver should not be used with root privileges. If you wish to continue as root, use --force.
💡  If you are running minikube within a VM, consider using --driver=none:
📘    https://minikube.sigs.k8s.io/docs/reference/drivers/none/

❌  Exiting due to DRV_AS_ROOT: The "podman" driver should not be used with root privileges.

root@adsl-dynamic-ipv6:/home/rashmika/Documents/My_K8s_Projects/deployments# cd
root@adsl-dynamic-ipv6:~# minikube start
😄  minikube v1.36.0 on Fedora 42 (vbox/amd64)
✨  Automatically selected the qemu2 driver. Other choices: podman, none, ssh
🛑  The "qemu2" driver should not be used with root privileges. If you wish to continue as root, use --force.
💡  If you are running minikube within a VM, consider using --driver=none:
📘    https://minikube.sigs.k8s.io/docs/reference/drivers/none/

❌  Exiting due to DRV_AS_ROOT: The "qemu2" driver should not be used with root privileges.

root@adsl-dynamic-ipv6:~# kubectl config get-contexts
CURRENT   NAME   CLUSTER   AUTHINFO   NAMESPACE

root@adsl-dynamic-ipv6:~# kubectl config get-contexts
CURRENT   NAME   CLUSTER   AUTHINFO   NAMESPACE
root@adsl-dynamic-ipv6:~# ^C
root@adsl-dynamic-ipv6:~# sudo su
root@adsl-dynamic-ipv6:~# exit
exit
root@adsl-dynamic-ipv6:~# sudo su -rashmika
su: invalid option -- 'r'
Try 'su --help' for more information.
root@adsl-dynamic-ipv6:~# sudo su --rashmika
su: unrecognized option '--rashmika'
Try 'su --help' for more information.
root@adsl-dynamic-ipv6:~# sudo -rashmika
usage: sudo -h | -K | -k | -V
usage: sudo -v [-ABkNnS] [-g group] [-h host] [-p prompt] [-u user]
usage: sudo -l [-ABkNnS] [-g group] [-h host] [-p prompt] [-U user]
            [-u user] [command [arg ...]]
usage: sudo [-ABbEHkNnPS] [-r role] [-t type] [-C num] [-D directory]
            [-g group] [-h host] [-p prompt] [-R directory] [-T timeout]
            [-u user] [VAR=value] [-i | -s] [command [arg ...]]
usage: sudo -e [-ABkNnS] [-r role] [-t type] [-C num] [-D directory]
            [-g group] [-h host] [-p prompt] [-R directory] [-T timeout]
            [-u user] file ...
root@adsl-dynamic-ipv6:~# sudo rashmika
sudo: rashmika: command not found
root@adsl-dynamic-ipv6:~# su -raashmika
su: invalid option -- 'r'
Try 'su --help' for more information.
root@adsl-dynamic-ipv6:~# su -rashmika
su: invalid option -- 'r'
Try 'su --help' for more information.
root@adsl-dynamic-ipv6:~# su - rashmika
rashmika@adsl-dynamic-ipv6:~$ kubectl config get-contexts
CURRENT   NAME        CLUSTER     AUTHINFO    NAMESPACE
*         kind-kind   kind-kind   kind-kind   
          minikube    minikube    minikube    default
rashmika@adsl-dynamic-ipv6:~$ ll
total 188432
drwxr-xr-x. 1 rashmika rashmika         0 May 29 11:20 Desktop
drwxr-xr-x. 1 rashmika rashmika        76 Jun 18 13:13 Documents
drwxr-xr-x. 1 rashmika rashmika       104 Jun  2 10:00 Downloads
-rw-r--r--. 1 root     root      60121272 Jun 12 11:42 kubectl
-rw-r--r--. 1 rashmika rashmika     10174 Apr 20  2024 LICENSE
drwxr-xr-x. 1 rashmika rashmika         0 Jun  2 11:55 Media
-rw-r--r--. 1 root     root     132766301 Jun 11 16:45 minikube-linux-amd64
drwxr-xr-x. 1 rashmika rashmika         0 May 29 11:20 Music
drwxr-xr-x. 1 rashmika rashmika         0 May 29 11:20 Pictures
drwxr-xr-x. 1 rashmika rashmika         0 May 29 11:20 Public
-rw-r--r--. 1 rashmika rashmika     49052 Apr 19 23:37 README.md
drwxr-xr-x. 1 rashmika rashmika         0 May 29 11:20 Templates
drwxr-xr-x. 1 rashmika rashmika         0 May 29 11:20 Videos
rashmika@adsl-dynamic-ipv6:~$ cd Documents
rashmika@adsl-dynamic-ipv6:~/Documents$ ll
total 0
drwxr-xr-x. 1 root     root     100 Jun 18 13:36 My_K8s_Projects
drwxr-xr-x. 1 rashmika rashmika 130 Jun  3 16:46 PFX_Certificate
drwxr-xr-x. 1 root     root      82 Jun 11 10:09 testdata
rashmika@adsl-dynamic-ipv6:~/Documents$ cd My_K8s_Projects
rashmika@adsl-dynamic-ipv6:~/Documents/My_K8s_Projects$ cd deployments
rashmika@adsl-dynamic-ipv6:~/Documents/My_K8s_Projects/deployments$ ll
total 4
-rw-r--r--. 1 root root 455 Jun 18 13:35 nginx_deploy.yaml
rashmika@adsl-dynamic-ipv6:~/Documents/My_K8s_Projects/deployments$ nano nginxx_deploy.yaml
rashmika@adsl-dynamic-ipv6:~/Documents/My_K8s_Projects/deployments$ nano nginx_deploy.yaml
rashmika@adsl-dynamic-ipv6:~/Documents/My_K8s_Projects/deployments$ ll
total 4
-rw-r--r--. 1 root root 455 Jun 18 13:35 nginx_deploy.yaml
rashmika@adsl-dynamic-ipv6:~/Documents/My_K8s_Projects/deployments$ cd
rashmika@adsl-dynamic-ipv6:~$ kubectl get deploy
No resources found in default namespace.
rashmika@adsl-dynamic-ipv6:~$ kubectl get pods
No resources found in default namespace.
rashmika@adsl-dynamic-ipv6:~$ kubectl get nodes
NAME                 STATUS   ROLES           AGE    VERSION
kind-control-plane   Ready    control-plane   117m   v1.29.2
rashmika@adsl-dynamic-ipv6:~$ kubectl create -f nginx_deploy.yaml
error: the path "nginx_deploy.yaml" does not exist
rashmika@adsl-dynamic-ipv6:~$ cd /Documents/My_K8s_Projects/deployments
-bash: cd: /Documents/My_K8s_Projects/deployments: Not a directory
rashmika@adsl-dynamic-ipv6:~$ cd Documents/My_K8s_Projects/deployments
rashmika@adsl-dynamic-ipv6:~/Documents/My_K8s_Projects/deployments$ kubectl create -f nginx_deploy.yaml
The Deployment "nginx_deploy" is invalid: metadata.name: Invalid value: "nginx_deploy": a lowercase RFC 1123 subdomain must consist of lower case alphanumeric characters, '-' or '.', and must start and end with an alphanumeric character (e.g. 'example.com', regex used for validation is '[a-z0-9]([-a-z0-9]*[a-z0-9])?(\.[a-z0-9]([-a-z0-9]*[a-z0-9])?)*')
rashmika@adsl-dynamic-ipv6:~/Documents/My_K8s_Projects/deployments$ nano nginx_deploy.yaml
rashmika@adsl-dynamic-ipv6:~/Documents/My_K8s_Projects/deployments$ nano nginx_deploy.yaml
rashmika@adsl-dynamic-ipv6:~/Documents/My_K8s_Projects/deployments$ nano nginx_deploy.yaml
rashmika@adsl-dynamic-ipv6:~/Documents/My_K8s_Projects/deployments$ nano nginx_deploy.yaml
rashmika@adsl-dynamic-ipv6:~/Documents/My_K8s_Projects/deployments$ 
rashmika@adsl-dynamic-ipv6:~/Documents/My_K8s_Projects/deployments$ sudo nano nginx_deploy.yaml
[sudo] password for rashmika: 
rashmika@adsl-dynamic-ipv6:~/Documents/My_K8s_Projects/deployments$ kubectl create -f nginx_deploy.yaml
deployment.apps/nginx-deploy created
rashmika@adsl-dynamic-ipv6:~/Documents/My_K8s_Projects/deployments$ kubectl get deploy
NAME           READY   UP-TO-DATE   AVAILABLE   AGE
nginx-deploy   0/3     0            0           14s
rashmika@adsl-dynamic-ipv6:~/Documents/My_K8s_Projects/deployments$ kubectl get nodes
NAME                 STATUS   ROLES           AGE    VERSION
kind-control-plane   Ready    control-plane   142m   v1.29.2
rashmika@adsl-dynamic-ipv6:~/Documents/My_K8s_Projects/deployments$ kubectl get pods
No resources found in default namespace.
rashmika@adsl-dynamic-ipv6:~/Documents/My_K8s_Projects/deployments$ cd /Documents/My_K8s_Projects/deployments^C
rashmika@adsl-dynamic-ipv6:~/Documents/My_K8s_Projects/deployments$ 
rashmika@adsl-dynamic-ipv6:~/Documents/My_K8s_Projects/deployments$ kubectl get deploy
NAME           READY   UP-TO-DATE   AVAILABLE   AGE
nginx-deploy   0/3     3            0           17m
rashmika@adsl-dynamic-ipv6:~/Documents/My_K8s_Projects/deployments$ kubectl delete deploy nginx-deploy
deployment.apps "nginx-deploy" deleted
rashmika@adsl-dynamic-ipv6:~/Documents/My_K8s_Projects/deployments$ kubectl get deploy
No resources found in default namespace.
rashmika@adsl-dynamic-ipv6:~/Documents/My_K8s_Projects/deployments$ kubectl create -f nginx_deploy.yaml
deployment.apps/nginx-deploy created
rashmika@adsl-dynamic-ipv6:~/Documents/My_K8s_Projects/deployments$ kubectl get deploy
NAME           READY   UP-TO-DATE   AVAILABLE   AGE
nginx-deploy   0/3     0            0           14s
rashmika@adsl-dynamic-ipv6:~/Documents/My_K8s_Projects/deployments$ kubectl get nodes
NAME                 STATUS   ROLES           AGE    VERSION
kind-control-plane   Ready    control-plane   142m   v1.29.2
rashmika@adsl-dynamic-ipv6:~/Documents/My_K8s_Projects/deployments$ kubectl get pods
No resources found in default namespace.
rashmika@adsl-dynamic-ipv6:~/Documents/My_K8s_Projects/deployments$ cd /Documents/My_K8s_Projects/deployments^C
rashmika@adsl-dynamic-ipv6:~/Documents/My_K8s_Projects/deployments$ kubectl delete deploy nginx_deploy
Unable to connect to the server: net/http: TLS handshake timeout
rashmika@adsl-dynamic-ipv6:~/Documents/My_K8s_Projects/deployments$ kubectl delete deploy nginx_deploy
Unable to connect to the server: net/http: TLS handshake timeout
rashmika@adsl-dynamic-ipv6:~/Documents/My_K8s_Projects/deployments$ kubectl get deploy
Unable to connect to the server: net/http: TLS handshake timeout
rashmika@adsl-dynamic-ipv6:~/Documents/My_K8s_Projects/deployments$ kubectl ip
error: unknown command "ip" for "kubectl"

Did you mean this?
	top
	cp
rashmika@adsl-dynamic-ipv6:~/Documents/My_K8s_Projects/deployments$ kind ip
ERROR: unknown command "ip" for "kind"
rashmika@adsl-dynamic-ipv6:~/Documents/My_K8s_Projects/deployments$ kind profile list
ERROR: unknown command "profile" for "kind"
rashmika@adsl-dynamic-ipv6:~/Documents/My_K8s_Projects/deployments$ sudo kind profile list
[sudo] password for rashmika: 
ERROR: unknown command "profile" for "kind"
rashmika@adsl-dynamic-ipv6:~/Documents/My_K8s_Projects/deployments$ kind-kind profile list
bash: kind-kind: command not found...
^[[A^[[A^[[A^C
rashmika@adsl-dynamic-ipv6:~/Documents/My_K8s_Projects/deployments$ kind-kind ip
bash: kind-kind: command not found...
^[[A^[[A^[[A^[[A^[[A^[[A^C
rashmika@adsl-dynamic-ipv6:~/Documents/My_K8s_Projects/deployments$ kubectl delete deploy nginx_deploy
Error from server (NotFound): deployments.apps "nginx_deploy" not found
rashmika@adsl-dynamic-ipv6:~/Documents/My_K8s_Projects/deployments$ kubectl get deploy
NAME           READY   UP-TO-DATE   AVAILABLE   AGE
nginx-deploy   0/3     3            0           17m
rashmika@adsl-dynamic-ipv6:~/Documents/My_K8s_Projects/deployments$ kubectl delete deploy nginx-deploy
deployment.apps "nginx-deploy" deleted
rashmika@adsl-dynamic-ipv6:~/Documents/My_K8s_Projects/deployments$ kubectl get deploy
No resources found in default namespace.
rashmika@adsl-dynamic-ipv6:~/Documents/My_K8s_Projects/deployments$ kubectl get ns
NAME                 STATUS   AGE
default              Active   165m
kube-node-lease      Active   165m
kube-public          Active   165m
kube-system          Active   165m
local-path-storage   Active   163m
rashmika@adsl-dynamic-ipv6:~/Documents/My_K8s_Projects/deployments$ cd ..
rashmika@adsl-dynamic-ipv6:~/Documents/My_K8s_Projects$ cd namespace
-bash: cd: namespace: No such file or directory
rashmika@adsl-dynamic-ipv6:~/Documents/My_K8s_Projects$ cd namespaces
rashmika@adsl-dynamic-ipv6:~/Documents/My_K8s_Projects/namespaces$ kubectl create namespace myspace --dry-run=client -o yaml > myspace.yaml
-bash: myspace.yaml: Permission denied
rashmika@adsl-dynamic-ipv6:~/Documents/My_K8s_Projects/namespaces$ sudo kubectl create namespace myspace --dry-run=client -o yaml > myspace.yaml
-bash: myspace.yaml: Permission denied
rashmika@adsl-dynamic-ipv6:~/Documents/My_K8s_Projects/namespaces$ sudo chmod +x /Documents/My_K8s_Projects/namespaces
[sudo] password for rashmika: 
chmod: cannot access '/Documents/My_K8s_Projects/namespaces': Not a directory
rashmika@adsl-dynamic-ipv6:~/Documents/My_K8s_Projects/namespaces$ sudo chmod +x /Documents/My_K8s_Projects/
chmod: cannot access '/Documents/My_K8s_Projects/': Not a directory
rashmika@adsl-dynamic-ipv6:~/Documents/My_K8s_Projects/namespaces$ sudo kubectl create namespace myspace --dry-run=client -o yaml > myspace.yaml
-bash: myspace.yaml: Permission denied
rashmika@adsl-dynamic-ipv6:~/Documents/My_K8s_Projects/namespaces$ sudo kubectl create namespace myspace --dry-run=client -o yaml > sudo tee myspace.yaml
-bash: sudo: Permission denied
rashmika@adsl-dynamic-ipv6:~/Documents/My_K8s_Projects/namespaces$ sudo chown -R $USER:$USER ~/Documents/My_K8s_Projects
[sudo] password for rashmika: 
rashmika@adsl-dynamic-ipv6:~/Documents/My_K8s_Projects/namespaces$ sudo kubectl create namespace myspace --dry-run=client -o yaml > myspace.yaml
rashmika@adsl-dynamic-ipv6:~/Documents/My_K8s_Projects/namespaces$ ll
total 4
-rw-r--r--. 1 rashmika rashmika 103 Jun 18 15:12 myspace.yaml
rashmika@adsl-dynamic-ipv6:~/Documents/My_K8s_Projects/namespaces$ nano myspace.yaml
rashmika@adsl-dynamic-ipv6:~/Documents/My_K8s_Projects/namespaces$ kubectl ns
error: unknown command "ns" for "kubectl"

Did you mean this?
	cp
rashmika@adsl-dynamic-ipv6:~/Documents/My_K8s_Projects/namespaces$ cd
rashmika@adsl-dynamic-ipv6:~$ kubectl get ns
NAME                 STATUS   AGE
default              Active   3h6m
kube-node-lease      Active   3h6m
kube-public          Active   3h6m
kube-system          Active   3h6m
local-path-storage   Active   3h3m
rashmika@adsl-dynamic-ipv6:~$ cd /Documents/My_K8s_Projects/namespaces
-bash: cd: /Documents/My_K8s_Projects/namespaces: Not a directory
rashmika@adsl-dynamic-ipv6:~$ cd Documents/My_K8s_Projects/namespaces
rashmika@adsl-dynamic-ipv6:~/Documents/My_K8s_Projects/namespaces$ kubectl apply -f namespce.yaml
error: the path "namespce.yaml" does not exist
rashmika@adsl-dynamic-ipv6:~/Documents/My_K8s_Projects/namespaces$ kubectl apply -f namespace.yaml
error: the path "namespace.yaml" does not exist
rashmika@adsl-dynamic-ipv6:~/Documents/My_K8s_Projects/namespaces$ kubectl apply -f myspace.yaml
namespace/myspace created
rashmika@adsl-dynamic-ipv6:~/Documents/My_K8s_Projects/namespaces$ kubectl get ns
NAME                 STATUS   AGE
default              Active   3h9m
kube-node-lease      Active   3h9m
kube-public          Active   3h9m
kube-system          Active   3h9m
local-path-storage   Active   3h6m
myspace              Active   20s
rashmika@adsl-dynamic-ipv6:~/Documents/My_K8s_Projects/namespaces$ kubectl get pods --all namespaces
error: unknown flag: --all
See 'kubectl get --help' for usage.
rashmika@adsl-dynamic-ipv6:~/Documents/My_K8s_Projects/namespaces$ kubectl get pods --all-namespaces
NAMESPACE            NAME                                         READY   STATUS             RESTARTS         AGE
kube-system          coredns-76f75df574-4dnnd                     1/1     Running            0                3h10m
kube-system          coredns-76f75df574-wnbx5                     1/1     Running            0                3h10m
kube-system          etcd-kind-control-plane                      1/1     Running            0                3h13m
kube-system          kindnet-rzcx9                                1/1     Running            3 (37m ago)      3h10m
kube-system          kube-apiserver-kind-control-plane            1/1     Running            2                3h13m
kube-system          kube-controller-manager-kind-control-plane   0/1     CrashLoopBackOff   33 (42s ago)     3h13m
kube-system          kube-proxy-5g9bd                             1/1     Running            0                3h10m
kube-system          kube-scheduler-kind-control-plane            1/1     Running            29 (2m16s ago)   3h13m
local-path-storage   local-path-provisioner-7577fdbbfb-dnlvw      1/1     Running            0                3h10m
rashmika@adsl-dynamic-ipv6:~/Documents/My_K8s_Projects/namespaces$ kubectl get pods -n kube-system
NAME                                         READY   STATUS             RESTARTS         AGE
coredns-76f75df574-4dnnd                     1/1     Running            0                3h14m
coredns-76f75df574-wnbx5                     1/1     Running            0                3h14m
etcd-kind-control-plane                      1/1     Running            0                3h17m
kindnet-rzcx9                                1/1     Running            3 (41m ago)      3h14m
kube-apiserver-kind-control-plane            1/1     Running            2                3h17m
kube-controller-manager-kind-control-plane   0/1     CrashLoopBackOff   33 (4m24s ago)   3h17m
kube-proxy-5g9bd                             1/1     Running            0                3h14m
kube-scheduler-kind-control-plane            0/1     CrashLoopBackOff   29 (32s ago)     3h17m
rashmika@adsl-dynamic-ipv6:~/Documents/My_K8s_Projects/namespaces$ kubectl config set-context --current --namespace=default
Context "kind-kind" modified.
rashmika@adsl-dynamic-ipv6:~/Documents/My_K8s_Projects/namespaces$ kubectl config get-context
error: unknown command "get-context"
See 'kubectl config -h' for help and examples
rashmika@adsl-dynamic-ipv6:~/Documents/My_K8s_Projects/namespaces$ kubectl config current-context
kind-kind
rashmika@adsl-dynamic-ipv6:~/Documents/My_K8s_Projects/namespaces$ kubectl config current-context -ns
kind-kind
rashmika@adsl-dynamic-ipv6:~/Documents/My_K8s_Projects/namespaces$ kubectl config view --minify --output 'jsonpath={..namespace}'
defaultrashmika@adsl-dynamic-ipv6:~/Documents/My_K8s_Projects/namespaces$ kubectl config set-context --current --namespace=myspace
Context "kind-kind" modified.
rashmika@adsl-dynamic-ipv6:~/Documents/My_K8s_Projects/namespaces$ kubectl config view --minify --output 'jsonpath={..namespace}'
myspacerashmika@adsl-dynamic-ipv6:~/Documents/My_K8s_Projects/namespaces$ kubectl config set-context --current --namespace=default
Context "kind-kind" modified.
rashmika@adsl-dynamic-ipv6:~/Documents/My_K8s_Projects/namespaces$ kubectl config view --minify --output 'jsonpath={..namespace}'
defaultrashmika@adsl-dynamic-ipv6:~/Documents/My_K8s_Projects/namespaces$ kubectl get nodes
NAME                 STATUS   ROLES           AGE     VERSION
kind-control-plane   Ready    control-plane   4h13m   v1.29.2
rashmika@adsl-dynamic-ipv6:~/Documents/My_K8s_Projects/namespaces$ kubectl describe node kind-control-plane
Name:               kind-control-plane
Roles:              control-plane
Labels:             beta.kubernetes.io/arch=amd64
                    beta.kubernetes.io/os=linux
                    kubernetes.io/arch=amd64
                    kubernetes.io/hostname=kind-control-plane
                    kubernetes.io/os=linux
                    node-role.kubernetes.io/control-plane=
Annotations:        kubeadm.alpha.kubernetes.io/cri-socket: unix:///run/containerd/containerd.sock
                    node.alpha.kubernetes.io/ttl: 0
                    volumes.kubernetes.io/controller-managed-attach-detach: true
CreationTimestamp:  Wed, 18 Jun 2025 12:12:00 +0530
Taints:             <none>
Unschedulable:      false
Lease:
  HolderIdentity:  kind-control-plane
  AcquireTime:     <unset>
  RenewTime:       Wed, 18 Jun 2025 16:26:34 +0530
Conditions:
  Type             Status  LastHeartbeatTime                 LastTransitionTime                Reason                       Message
  ----             ------  -----------------                 ------------------                ------                       -------
  MemoryPressure   False   Wed, 18 Jun 2025 16:23:51 +0530   Wed, 18 Jun 2025 12:11:57 +0530   KubeletHasSufficientMemory   kubelet has sufficient memory available
  DiskPressure     False   Wed, 18 Jun 2025 16:23:51 +0530   Wed, 18 Jun 2025 12:11:57 +0530   KubeletHasNoDiskPressure     kubelet has no disk pressure
  PIDPressure      False   Wed, 18 Jun 2025 16:23:51 +0530   Wed, 18 Jun 2025 12:11:57 +0530   KubeletHasSufficientPID      kubelet has sufficient PID available
  Ready            True    Wed, 18 Jun 2025 16:23:51 +0530   Wed, 18 Jun 2025 12:16:30 +0530   KubeletReady                 kubelet is posting ready status
Addresses:
  InternalIP:  172.18.0.2
  Hostname:    kind-control-plane
Capacity:
  cpu:                2
  ephemeral-storage:  39933Mi
  hugepages-2Mi:      0
  memory:             2366016Ki
  pods:               110
Allocatable:
  cpu:                2
  ephemeral-storage:  39933Mi
  hugepages-2Mi:      0
  memory:             2366016Ki
  pods:               110
System Info:
  Machine ID:                 a7fc60b652fd4d4b8a4b08648ffa52ca
  System UUID:                d7c331d9-944d-4227-811d-d53bcb8a7762
  Boot ID:                    53d46502-9a75-4e7b-a6d7-e05b740faccc
  Kernel Version:             6.14.9-300.fc42.x86_64
  OS Image:                   Debian GNU/Linux 12 (bookworm)
  Operating System:           linux
  Architecture:               amd64
  Container Runtime Version:  containerd://1.7.13
  Kubelet Version:            v1.29.2
  Kube-Proxy Version:         v1.29.2
PodCIDR:                      10.244.0.0/24
PodCIDRs:                     10.244.0.0/24
ProviderID:                   kind://docker/kind/kind-control-plane
Non-terminated Pods:          (9 in total)
  Namespace                   Name                                          CPU Requests  CPU Limits  Memory Requests  Memory Limits  Age
  ---------                   ----                                          ------------  ----------  ---------------  -------------  ---
  kube-system                 coredns-76f75df574-4dnnd                      100m (5%)     0 (0%)      70Mi (3%)        170Mi (7%)     4h11m
  kube-system                 coredns-76f75df574-wnbx5                      100m (5%)     0 (0%)      70Mi (3%)        170Mi (7%)     4h11m
  kube-system                 etcd-kind-control-plane                       100m (5%)     0 (0%)      100Mi (4%)       0 (0%)         4h14m
  kube-system                 kindnet-rzcx9                                 100m (5%)     100m (5%)   50Mi (2%)        50Mi (2%)      4h11m
  kube-system                 kube-apiserver-kind-control-plane             250m (12%)    0 (0%)      0 (0%)           0 (0%)         4h14m
  kube-system                 kube-controller-manager-kind-control-plane    200m (10%)    0 (0%)      0 (0%)           0 (0%)         4h14m
  kube-system                 kube-proxy-5g9bd                              0 (0%)        0 (0%)      0 (0%)           0 (0%)         4h11m
  kube-system                 kube-scheduler-kind-control-plane             100m (5%)     0 (0%)      0 (0%)           0 (0%)         4h14m
  local-path-storage          local-path-provisioner-7577fdbbfb-dnlvw       0 (0%)        0 (0%)      0 (0%)           0 (0%)         4h11m
Allocated resources:
  (Total limits may be over 100 percent, i.e., overcommitted.)
  Resource           Requests     Limits
  --------           --------     ------
  cpu                950m (47%)   100m (5%)
  memory             290Mi (12%)  390Mi (16%)
  ephemeral-storage  0 (0%)       0 (0%)
  hugepages-2Mi      0 (0%)       0 (0%)
Events:
  Type    Reason          Age   From             Message
  ----    ------          ----  ----             -------
  Normal  RegisteredNode  54m   node-controller  Node kind-control-plane event: Registered Node kind-control-plane in Controller
  Normal  RegisteredNode  40m   node-controller  Node kind-control-plane event: Registered Node kind-control-plane in Controller
  Normal  RegisteredNode  26m   node-controller  Node kind-control-plane event: Registered Node kind-control-plane in Controller
  Normal  RegisteredNode  18m   node-controller  Node kind-control-plane event: Registered Node kind-control-plane in Controller
rashmika@adsl-dynamic-ipv6:~/Documents/My_K8s_Projects/namespaces$ kubectl get pods
No resources found in default namespace.
rashmika@adsl-dynamic-ipv6:~/Documents/My_K8s_Projects/namespaces$ ^C
rashmika@adsl-dynamic-ipv6:~/Documents/My_K8s_Projects/namespaces$ ^C
rashmika@adsl-dynamic-ipv6:~/Documents/My_K8s_Projects/namespaces$ ^C
rashmika@adsl-dynamic-ipv6:~/Documents/My_K8s_Projects/namespaces$ ^C
rashmika@adsl-dynamic-ipv6:~/Documents/My_K8s_Projects/namespaces$ ^C
rashmika@adsl-dynamic-ipv6:~/Documents/My_K8s_Projects/namespaces$ ^C
rashmika@adsl-dynamic-ipv6:~/Documents/My_K8s_Projects/namespaces$ kubectl run nginxpod --image=nginx
pod/nginxpod created
rashmika@adsl-dynamic-ipv6:~/Documents/My_K8s_Projects/namespaces$ kubectl get pods
NAME       READY   STATUS    RESTARTS   AGE
nginxpod   0/1     Pending   0          20s
rashmika@adsl-dynamic-ipv6:~/Documents/My_K8s_Projects/namespaces$ kubectl get pod -o wide
NAME       READY   STATUS    RESTARTS   AGE   IP       NODE     NOMINATED NODE   READINESS GATES
nginxpod   0/1     Pending   0          46s   <none>   <none>   <none>           <none>
rashmika@adsl-dynamic-ipv6:~/Documents/My_K8s_Projects/namespaces$ kubectl get pod -o wide
NAME       READY   STATUS    RESTARTS   AGE   IP       NODE     NOMINATED NODE   READINESS GATES
nginxpod   0/1     Pending   0          65s   <none>   <none>   <none>           <none>
rashmika@adsl-dynamic-ipv6:~/Documents/My_K8s_Projects/namespaces$ kubectl get pod -o wide
NAME       READY   STATUS    RESTARTS   AGE    IP           NODE                 NOMINATED NODE   READINESS GATES
nginxpod   1/1     Running   0          3m8s   10.244.0.8   kind-control-plane   <none>           <none>
rashmika@adsl-dynamic-ipv6:~/Documents/My_K8s_Projects/namespaces$ kubectl describe pod nginxpod
Name:             nginxpod
Namespace:        default
Priority:         0
Service Account:  default
Node:             kind-control-plane/172.18.0.2
Start Time:       Wed, 18 Jun 2025 17:12:50 +0530
Labels:           run=nginxpod
Annotations:      <none>
Status:           Running
IP:               10.244.0.8
IPs:
  IP:  10.244.0.8
Containers:
  nginxpod:
    Container ID:   containerd://b01687b27700b74b207d609b18661889526b59827aeb07620950a25da54a0761
    Image:          nginx
    Image ID:       docker.io/library/nginx@sha256:6784fb0834aa7dbbe12e3d7471e69c290df3e6ba810dc38b34ae33d3c1c05f7d
    Port:           <none>
    Host Port:      <none>
    State:          Running
      Started:      Wed, 18 Jun 2025 17:13:20 +0530
    Ready:          True
    Restart Count:  0
    Environment:    <none>
    Mounts:
      /var/run/secrets/kubernetes.io/serviceaccount from kube-api-access-vq825 (ro)
Conditions:
  Type                        Status
  PodReadyToStartContainers   True 
  Initialized                 True 
  Ready                       True 
  ContainersReady             True 
  PodScheduled                True 
Volumes:
  kube-api-access-vq825:
    Type:                    Projected (a volume that contains injected data from multiple sources)
    TokenExpirationSeconds:  3607
    ConfigMapName:           kube-root-ca.crt
    Optional:                false
    DownwardAPI:             true
QoS Class:                   BestEffort
Node-Selectors:              <none>
Tolerations:                 node.kubernetes.io/not-ready:NoExecute op=Exists for 300s
                             node.kubernetes.io/unreachable:NoExecute op=Exists for 300s
Events:
  Type    Reason     Age   From               Message
  ----    ------     ----  ----               -------
  Normal  Scheduled  2m6s  default-scheduler  Successfully assigned default/nginxpod to kind-control-plane
  Normal  Pulling    110s  kubelet            Pulling image "nginx"
  Normal  Pulled     103s  kubelet            Successfully pulled image "nginx" in 6.981s (6.981s including waiting)
  Normal  Created    101s  kubelet            Created container nginxpod
  Normal  Started    94s   kubelet            Started container nginxpod
rashmika@adsl-dynamic-ipv6:~/Documents/My_K8s_Projects/namespaces$ kubectl delete pod nginxpod
pod "nginxpod" deleted
^Crashmika@adsl-dynamic-ipv6:~/Documents/My_K8s_Projects/namespaces$ kubectl get pods
NAME       READY   STATUS        RESTARTS   AGE
nginxpod   0/1     Terminating   0          10m
rashmika@adsl-dynamic-ipv6:~/Documents/My_K8s_Projects/namespaces$ kubectl run busyboxpod --image=busybox -it -- /bin/sh

Error from server (Timeout): Timeout: request did not complete within requested timeout - context deadline exceeded
rashmika@adsl-dynamic-ipv6:~/Documents/My_K8s_Projects/namespaces$ 
rashmika@adsl-dynamic-ipv6:~/Documents/My_K8s_Projects/namespaces$ kubectl run busyboxpod --image=busybox -it -- /bin/sh
Unable to connect to the server: http2: client connection lost
rashmika@adsl-dynamic-ipv6:~/Documents/My_K8s_Projects/namespaces$ kubectl run busyboxpod --image=busybox -it -- /bin/sh
Unable to connect to the server: read tcp 127.0.0.1:55984->127.0.0.1:33561: read: connection reset by peer
rashmika@adsl-dynamic-ipv6:~/Documents/My_K8s_Projects/namespaces$ kubectl run busyboxpod --image=busybox -it -- /bin/sh
Unable to connect to the server: net/http: TLS handshake timeout
rashmika@adsl-dynamic-ipv6:~/Documents/My_K8s_Projects/namespaces$ kubectl run busyboxpod --image=busybox -it -- /bin/sh
Unable to connect to the server: net/http: TLS handshake timeout
rashmika@adsl-dynamic-ipv6:~/Documents/My_K8s_Projects/namespaces$ cd ..
rashmika@adsl-dynamic-ipv6:~/Documents/My_K8s_Projects$ kubectl run busyboxpod --image=busybox -it -- /bin/sh
Unable to connect to the server: net/http: TLS handshake timeout
rashmika@adsl-dynamic-ipv6:~/Documents/My_K8s_Projects$ minikube status
❗  Executing "docker container inspect minikube --format={{.State.Status}}" took an unusually long time: 4.196077068s
💡  Restarting the docker service may improve performance.
minikube
type: Control Plane
host: Running
kubelet: Running
apiserver: Stopped
kubeconfig: Configured

rashmika@adsl-dynamic-ipv6:~/Documents/My_K8s_Projects$ minikube stop
✋  Stopping node "minikube"  ...
❗  Executing "docker container inspect minikube --format={{.State.Status}}" took an unusually long time: 4.950311944s
💡  Restarting the docker service may improve performance.
🛑  Powering off "minikube" via SSH ...
🛑  1 node stopped.
rashmika@adsl-dynamic-ipv6:~/Documents/My_K8s_Projects$ kubectl run busyboxpod --image=busybox -it -- /bin/sh
If you don't see a command prompt, try pressing enter.
/ # ll
/bin/sh: ll: not found
/ # ls
bin           etc           lib           proc          product_uuid  sys           usr
dev           home          lib64         product_name  root          tmp           var
/ # echo -n 'This is a Secret' | base64
VGhpcyBpcyBhIFNlY3JldA==
/ # exit
Session ended, resume using 'kubectl attach busyboxpod -c busyboxpod -i -t' command when the pod is running
rashmika@adsl-dynamic-ipv6:~/Documents/My_K8s_Projects$ kubectl delete pod busyboxpod --grace-period=0 --force
Warning: Immediate deletion does not wait for confirmation that the running resource has been terminated. The resource may continue to run on the cluster indefinitely.
pod "busyboxpod" force deleted
rashmika@adsl-dynamic-ipv6:~/Documents/My_K8s_Projects$ kubectl create pod busyboxpod --image=busybox --dry-run=client -o yaml > busybox.yaml
error: unknown flag: --image
See 'kubectl create --help' for usage.
rashmika@adsl-dynamic-ipv6:~/Documents/My_K8s_Projects$ kubectl create pod busyboxpod --dry-run=client -o yaml > busybox.yaml
error: Unexpected args: [pod busyboxpod]
See 'kubectl create -h' for help and examples
rashmika@adsl-dynamic-ipv6:~/Documents/My_K8s_Projects$ ^C
rashmika@adsl-dynamic-ipv6:~/Documents/My_K8s_Projects$ 
.
.
.
.
.
.
.
.
apiVersion: v1
kind: Pod
metadata:
  creationTimestamp: null
  labels:
    run: busyboxpod
    app: busyboxpod
    type: front-end
  name: busyboxpod
spec:
  containers:
  - image: busybox
    name: busybox
    command: ["sleep", "3600"]
    resources:
      requests:
        cpu: 100m
        memory: 128Mi
      limits:
	cpu: 200m
        memory: 256Mi
    ports:
    - containerPort: 80
      name: http
      protocol: TCP
    env:
    -   name: DBCON
        value: myconnectionstring
  dnsPolicy: ClusterFirst
  restartPolicy: Always
status: {}

.
..
.
.
.
.

.
..
.
rashmika@adsl-dynamic-ipv6:~/Documents/My_K8s_Projects$ ^C
rashmika@adsl-dynamic-ipv6:~/Documents/My_K8s_Projects$ ^C
rashmika@adsl-dynamic-ipv6:~/Documents/My_K8s_Projects$ kubectl run busyboxpod --image=busybox --dry-run=client -o yaml > busybox.yaml
rashmika@adsl-dynamic-ipv6:~/Documents/My_K8s_Projects$ cd pods
rashmika@adsl-dynamic-ipv6:~/Documents/My_K8s_Projects/pods$ ll
total 0
rashmika@adsl-dynamic-ipv6:~/Documents/My_K8s_Projects/pods$ mv /Documents/My_K8s_Projects/busybox.yaml /Documents/My_K8s_Projects/pods
mv: cannot stat '/Documents/My_K8s_Projects/busybox.yaml': Not a directory
rashmika@adsl-dynamic-ipv6:~/Documents/My_K8s_Projects/pods$ cd ..
rashmika@adsl-dynamic-ipv6:~/Documents/My_K8s_Projects$ ll
total 4
-rw-r--r--. 1 rashmika rashmika 249 Jun 19 08:35 busybox.yaml
drwxr-xr-x. 1 rashmika rashmika   0 Jun 18 13:15 configmaps
drwxr-xr-x. 1 rashmika rashmika  34 Jun 18 13:36 deployments
drwxr-xr-x. 1 rashmika rashmika  24 Jun 18 15:12 namespaces
drwxr-xr-x. 1 rashmika rashmika   0 Jun 18 13:17 pods
drwxr-xr-x. 1 rashmika rashmika   0 Jun 18 13:16 secrets
drwxr-xr-x. 1 rashmika rashmika   0 Jun 18 13:15 services
rashmika@adsl-dynamic-ipv6:~/Documents/My_K8s_Projects$ mv busybox.yaml pods
rashmika@adsl-dynamic-ipv6:~/Documents/My_K8s_Projects$ cd pods
rashmika@adsl-dynamic-ipv6:~/Documents/My_K8s_Projects/pods$ ll
total 4
-rw-r--r--. 1 rashmika rashmika 249 Jun 19 08:35 busybox.yaml
rashmika@adsl-dynamic-ipv6:~/Documents/My_K8s_Projects/pods$ nano busybox.yaml
rashmika@adsl-dynamic-ipv6:~/Documents/My_K8s_Projects/pods$ kubectl create -f busybox.yaml
error: error parsing busybox.yaml: error converting YAML to JSON: yaml: line 15: did not find expected key
rashmika@adsl-dynamic-ipv6:~/Documents/My_K8s_Projects/pods$ nano busybox.yaml
rashmika@adsl-dynamic-ipv6:~/Documents/My_K8s_Projects/pods$ kubectl create -f busybox.yaml
error: error parsing busybox.yaml: error converting YAML to JSON: yaml: line 14: did not find expected key
rashmika@adsl-dynamic-ipv6:~/Documents/My_K8s_Projects/pods$ nano busybox.yaml
rashmika@adsl-dynamic-ipv6:~/Documents/My_K8s_Projects/pods$ nano busybox.yaml
rashmika@adsl-dynamic-ipv6:~/Documents/My_K8s_Projects/pods$ nano busybox.yaml
rashmika@adsl-dynamic-ipv6:~/Documents/My_K8s_Projects/pods$ kubectl create -f busybox.yaml
pod/busyboxpod created
rashmika@adsl-dynamic-ipv6:~/Documents/My_K8s_Projects/pods$ kubectl get pods
NAME         READY   STATUS             RESTARTS     AGE
busyboxpod   0/1     CrashLoopBackOff   1 (6s ago)   16s
rashmika@adsl-dynamic-ipv6:~/Documents/My_K8s_Projects/pods$ kubectl get pod -o wide
NAME         READY   STATUS      RESTARTS      AGE   IP            NODE                 NOMINATED NODE   READINESS GATES
busyboxpod   0/1     Completed   2 (26s ago)   36s   10.244.0.10   kind-control-plane   <none>           <none>
rashmika@adsl-dynamic-ipv6:~/Documents/My_K8s_Projects/pods$ kubectl describe pod busyboxpod
Name:             busyboxpod
Namespace:        default
Priority:         0
Service Account:  default
Node:             kind-control-plane/172.18.0.2
Start Time:       Thu, 19 Jun 2025 09:17:22 +0530
Labels:           app=busyboxpod
                  run=busyboxpod
                  type=front-end
Annotations:      <none>
Status:           Running
IP:               10.244.0.10
IPs:
  IP:  10.244.0.10
Containers:
  busyboxpod:
    Container ID:   containerd://2f6963f69292ff1980860b8cb86da10f46e9f826e26ffdc731137bfa21da6695
    Image:          busybox
    Image ID:       docker.io/library/busybox@sha256:f85340bf132ae937d2c2a763b8335c9bab35d6e8293f70f606b9c6178d84f42b
    Port:           80/TCP
    Host Port:      0/TCP
    State:          Waiting
      Reason:       CrashLoopBackOff
    Last State:     Terminated
      Reason:       Completed
      Exit Code:    0
      Started:      Thu, 19 Jun 2025 09:20:49 +0530
      Finished:     Thu, 19 Jun 2025 09:20:49 +0530
    Ready:          False
    Restart Count:  5
    Limits:
      cpu:     200m
      memory:  256Mi
    Requests:
      cpu:     100m
      memory:  128Mi
    Environment:
      DBCON:  myconnectionstring
    Mounts:
      /var/run/secrets/kubernetes.io/serviceaccount from kube-api-access-xrtgf (ro)
Conditions:
  Type                        Status
  PodReadyToStartContainers   True 
  Initialized                 True 
  Ready                       False 
  ContainersReady             False 
  PodScheduled                True 
Volumes:
  kube-api-access-xrtgf:
    Type:                    Projected (a volume that contains injected data from multiple sources)
    TokenExpirationSeconds:  3607
    ConfigMapName:           kube-root-ca.crt
    Optional:                false
    DownwardAPI:             true
QoS Class:                   Burstable
Node-Selectors:              <none>
Tolerations:                 node.kubernetes.io/not-ready:NoExecute op=Exists for 300s
                             node.kubernetes.io/unreachable:NoExecute op=Exists for 300s
Events:
  Type     Reason     Age                   From               Message
  ----     ------     ----                  ----               -------
  Normal   Scheduled  6m9s                  default-scheduler  Successfully assigned default/busyboxpod to kind-control-plane
  Normal   Pulled     6m5s                  kubelet            Successfully pulled image "busybox" in 2.483s (2.483s including waiting)
  Normal   Pulled     6m1s                  kubelet            Successfully pulled image "busybox" in 2.296s (2.296s including waiting)
  Normal   Pulled     5m45s                 kubelet            Successfully pulled image "busybox" in 1.96s (1.96s including waiting)
  Normal   Created    5m15s (x4 over 6m5s)  kubelet            Created container busyboxpod
  Normal   Pulled     5m15s                 kubelet            Successfully pulled image "busybox" in 2.242s (2.242s including waiting)
  Normal   Started    5m13s (x4 over 6m4s)  kubelet            Started container busyboxpod
  Normal   Pulling    4m20s (x5 over 6m8s)  kubelet            Pulling image "busybox"
  Warning  BackOff    60s (x23 over 5m59s)  kubelet            Back-off restarting failed container busyboxpod in pod busyboxpod_default(3c4e2a9f-1dc5-41b2-91b6-d95fe3bb46d3)
rashmika@adsl-dynamic-ipv6:~/Documents/My_K8s_Projects/pods$ kubectl exec -it busyboxpod --bash
error: unknown flag: --bash
See 'kubectl exec --help' for usage.
rashmika@adsl-dynamic-ipv6:~/Documents/My_K8s_Projects/pods$ kubectl exec -it busyboxpod -- bash
error: unable to upgrade connection: container not found ("busyboxpod")
rashmika@adsl-dynamic-ipv6:~/Documents/My_K8s_Projects/pods$ kubectl exec -it busyboxpod-pod -- bash
Error from server (NotFound): pods "busyboxpod-pod" not found
rashmika@adsl-dynamic-ipv6:~/Documents/My_K8s_Projects/pods$ kubectl exec -it busyboxpod -- bash
error: unable to upgrade connection: container not found ("busyboxpod")
rashmika@adsl-dynamic-ipv6:~/Documents/My_K8s_Projects/pods$ kubectl get pod -o wide
NAME         READY   STATUS             RESTARTS       AGE   IP            NODE                 NOMINATED NODE   READINESS GATES
busyboxpod   0/1     CrashLoopBackOff   6 (4m1s ago)   10m   10.244.0.10   kind-control-plane   <none>           <none>
rashmika@adsl-dynamic-ipv6:~/Documents/My_K8s_Projects/pods$ kubectl exec -it busyboxpod -- bash
error: unable to upgrade connection: container not found ("busyboxpod")
rashmika@adsl-dynamic-ipv6:~/Documents/My_K8s_Projects/pods$ kubectl exec -it busyboxpod -- sh
error: unable to upgrade connection: container not found ("busyboxpod")
rashmika@adsl-dynamic-ipv6:~/Documents/My_K8s_Projects/pods$ kubectl logs busybox
error: error from server (NotFound): pods "busybox" not found in namespace "default"
rashmika@adsl-dynamic-ipv6:~/Documents/My_K8s_Projects/pods$ kubectl logs busyboxpod
rashmika@adsl-dynamic-ipv6:~/Documents/My_K8s_Projects/pods$ nano busybox.yaml
rashmika@adsl-dynamic-ipv6:~/Documents/My_K8s_Projects/pods$ kubectl exec -it busyboxpod -- bash
error: unable to upgrade connection: container not found ("busyboxpod")
rashmika@adsl-dynamic-ipv6:~/Documents/My_K8s_Projects/pods$ kubectl logs busyboxpod
rashmika@adsl-dynamic-ipv6:~/Documents/My_K8s_Projects/pods$ ll
total 4
-rw-r--r--. 1 rashmika rashmika 562 Jun 19 09:35 busybox.yaml
rashmika@adsl-dynamic-ipv6:~/Documents/My_K8s_Projects/pods$ kubectl exec -it busybox-pod -- bash
Error from server (NotFound): pods "busybox-pod" not found
rashmika@adsl-dynamic-ipv6:~/Documents/My_K8s_Projects/pods$ kubectl exec -it busybox-- bash
error: exec [POD] [COMMAND] is not supported anymore. Use exec [POD] -- [COMMAND] instead
See 'kubectl exec -h' for help and examples
rashmika@adsl-dynamic-ipv6:~/Documents/My_K8s_Projects/pods$ kubectl exec -it busybox -- bash
Error from server (NotFound): pods "busybox" not found
rashmika@adsl-dynamic-ipv6:~/Documents/My_K8s_Projects/pods$ kubectl exec -it busyboxpod -- bash

error: unable to upgrade connection: container not found ("busyboxpod")
rashmika@adsl-dynamic-ipv6:~/Documents/My_K8s_Projects/pods$ 
rashmika@adsl-dynamic-ipv6:~/Documents/My_K8s_Projects/pods$ nano busybox.yaml
rashmika@adsl-dynamic-ipv6:~/Documents/My_K8s_Projects/pods$ nano busybox.yaml
rashmika@adsl-dynamic-ipv6:~/Documents/My_K8s_Projects/pods$ kubectl exec -it busyboxpod -- bash

error: unable to upgrade connection: container not found ("busyboxpod")
rashmika@adsl-dynamic-ipv6:~/Documents/My_K8s_Projects/pods$ 
rashmika@adsl-dynamic-ipv6:~/Documents/My_K8s_Projects/pods$ kubectl exec -it busybox -- bash
Error from server (NotFound): pods "busybox" not found
rashmika@adsl-dynamic-ipv6:~/Documents/My_K8s_Projects/pods$ kubectl exec -it busyboxpod -- bash
error: unable to upgrade connection: container not found ("busyboxpod")
rashmika@adsl-dynamic-ipv6:~/Documents/My_K8s_Projects/pods$ kubectl get pods
NAME         READY   STATUS             RESTARTS      AGE
busyboxpod   0/1     CrashLoopBackOff   10 (3m ago)   29m
rashmika@adsl-dynamic-ipv6:~/Documents/My_K8s_Projects/pods$ kubectl logs busyboxpod
rashmika@adsl-dynamic-ipv6:~/Documents/My_K8s_Projects/pods$ nano busybox.yaml
rashmika@adsl-dynamic-ipv6:~/Documents/My_K8s_Projects/pods$ kubectl delete pod busyboxpod
pod "busyboxpod" deleted
rashmika@adsl-dynamic-ipv6:~/Documents/My_K8s_Projects/pods$ kubectl apply -f busyboxpod
error: the path "busyboxpod" does not exist
rashmika@adsl-dynamic-ipv6:~/Documents/My_K8s_Projects/pods$ kubectl apply -f busybox.yaml
pod/busyboxpod created
rashmika@adsl-dynamic-ipv6:~/Documents/My_K8s_Projects/pods$ kubectl get pods
NAME         READY   STATUS    RESTARTS   AGE
busyboxpod   1/1     Running   0          9s
rashmika@adsl-dynamic-ipv6:~/Documents/My_K8s_Projects/pods$ kubectl exec -it busyboxpod -- bash
error: Internal error occurred: error executing command in container: failed to exec in container: failed to start exec "42595e55233ba061ff079489cf96a651c797a6d713a17c9a91f085e4a1b642b4": OCI runtime exec failed: exec failed: unable to start container process: exec: "bash": executable file not found in $PATH: unknown
rashmika@adsl-dynamic-ipv6:~/Documents/My_K8s_Projects/pods$ kubectl get pods
NAME         READY   STATUS    RESTARTS   AGE
busyboxpod   1/1     Running   0          31s
rashmika@adsl-dynamic-ipv6:~/Documents/My_K8s_Projects/pods$ kubectl exec -it busyboxpod -- sh
/ # ll
sh: ll: not found
/ # ls
bin           etc           lib           proc          product_uuid  sys           usr
dev           home          lib64         product_name  root          tmp           var
/ # echo $DBCON
myconnectionstring
/ # exit
rashmika@adsl-dynamic-ipv6:~/Documents/My_K8s_Projects/pods$ nano busybox.yaml
rashmika@adsl-dynamic-ipv6:~/Documents/My_K8s_Projects/pods$ 

.
.
.

.
.
.
.

.
.
rashmika@adsl-dynamic-ipv6:~/Documents/My_K8s_Projects$ ^C
rashmika@adsl-dynamic-ipv6:~/Documents/My_K8s_Projects$ kubectl run busyboxpod --image=busybox --dry-run=client -o yaml > busybox.yaml
rashmika@adsl-dynamic-ipv6:~/Documents/My_K8s_Projects$ cd pods
rashmika@adsl-dynamic-ipv6:~/Documents/My_K8s_Projects/pods$ ll
total 0
rashmika@adsl-dynamic-ipv6:~/Documents/My_K8s_Projects/pods$ mv /Documents/My_K8s_Projects/busybox.yaml /Documents/My_K8s_Projects/pods
mv: cannot stat '/Documents/My_K8s_Projects/busybox.yaml': Not a directory
rashmika@adsl-dynamic-ipv6:~/Documents/My_K8s_Projects/pods$ cd ..
rashmika@adsl-dynamic-ipv6:~/Documents/My_K8s_Projects$ ll
total 4
-rw-r--r--. 1 rashmika rashmika 249 Jun 19 08:35 busybox.yaml
drwxr-xr-x. 1 rashmika rashmika   0 Jun 18 13:15 configmaps
drwxr-xr-x. 1 rashmika rashmika  34 Jun 18 13:36 deployments
drwxr-xr-x. 1 rashmika rashmika  24 Jun 18 15:12 namespaces
drwxr-xr-x. 1 rashmika rashmika   0 Jun 18 13:17 pods
drwxr-xr-x. 1 rashmika rashmika   0 Jun 18 13:16 secrets
drwxr-xr-x. 1 rashmika rashmika   0 Jun 18 13:15 services
rashmika@adsl-dynamic-ipv6:~/Documents/My_K8s_Projects$ mv busybox.yaml pods
rashmika@adsl-dynamic-ipv6:~/Documents/My_K8s_Projects$ cd pods
rashmika@adsl-dynamic-ipv6:~/Documents/My_K8s_Projects/pods$ ll
total 4
-rw-r--r--. 1 rashmika rashmika 249 Jun 19 08:35 busybox.yaml
rashmika@adsl-dynamic-ipv6:~/Documents/My_K8s_Projects/pods$ nano busybox.yaml
rashmika@adsl-dynamic-ipv6:~/Documents/My_K8s_Projects/pods$ kubectl create -f busybox.yaml
error: error parsing busybox.yaml: error converting YAML to JSON: yaml: line 15: did not find expected key
rashmika@adsl-dynamic-ipv6:~/Documents/My_K8s_Projects/pods$ nano busybox.yaml
rashmika@adsl-dynamic-ipv6:~/Documents/My_K8s_Projects/pods$ kubectl create -f busybox.yaml
error: error parsing busybox.yaml: error converting YAML to JSON: yaml: line 14: did not find expected key
rashmika@adsl-dynamic-ipv6:~/Documents/My_K8s_Projects/pods$ nano busybox.yaml
rashmika@adsl-dynamic-ipv6:~/Documents/My_K8s_Projects/pods$ nano busybox.yaml
rashmika@adsl-dynamic-ipv6:~/Documents/My_K8s_Projects/pods$ nano busybox.yaml
rashmika@adsl-dynamic-ipv6:~/Documents/My_K8s_Projects/pods$ kubectl create -f busybox.yaml
pod/busyboxpod created
rashmika@adsl-dynamic-ipv6:~/Documents/My_K8s_Projects/pods$ kubectl get pods
NAME         READY   STATUS             RESTARTS     AGE
busyboxpod   0/1     CrashLoopBackOff   1 (6s ago)   16s
rashmika@adsl-dynamic-ipv6:~/Documents/My_K8s_Projects/pods$ kubectl get pod -o wide
NAME         READY   STATUS      RESTARTS      AGE   IP            NODE                 NOMINATED NODE   READINESS GATES
busyboxpod   0/1     Completed   2 (26s ago)   36s   10.244.0.10   kind-control-plane   <none>           <none>
rashmika@adsl-dynamic-ipv6:~/Documents/My_K8s_Projects/pods$ kubectl describe pod busyboxpod
Name:             busyboxpod
Namespace:        default
Priority:         0
Service Account:  default
Node:             kind-control-plane/172.18.0.2
Start Time:       Thu, 19 Jun 2025 09:17:22 +0530
Labels:           app=busyboxpod
                  run=busyboxpod
                  type=front-end
Annotations:      <none>
Status:           Running
IP:               10.244.0.10
IPs:
  IP:  10.244.0.10
Containers:
  busyboxpod:
    Container ID:   containerd://2f6963f69292ff1980860b8cb86da10f46e9f826e26ffdc731137bfa21da6695
    Image:          busybox
    Image ID:       docker.io/library/busybox@sha256:f85340bf132ae937d2c2a763b8335c9bab35d6e8293f70f606b9c6178d84f42b
    Port:           80/TCP
    Host Port:      0/TCP
    State:          Waiting
      Reason:       CrashLoopBackOff
    Last State:     Terminated
      Reason:       Completed
      Exit Code:    0
      Started:      Thu, 19 Jun 2025 09:20:49 +0530
      Finished:     Thu, 19 Jun 2025 09:20:49 +0530
    Ready:          False
    Restart Count:  5
    Limits:
      cpu:     200m
      memory:  256Mi
    Requests:
      cpu:     100m
      memory:  128Mi
    Environment:
      DBCON:  myconnectionstring
    Mounts:
      /var/run/secrets/kubernetes.io/serviceaccount from kube-api-access-xrtgf (ro)
Conditions:
  Type                        Status
  PodReadyToStartContainers   True 
  Initialized                 True 
  Ready                       False 
  ContainersReady             False 
  PodScheduled                True 
Volumes:
  kube-api-access-xrtgf:
    Type:                    Projected (a volume that contains injected data from multiple sources)
    TokenExpirationSeconds:  3607
    ConfigMapName:           kube-root-ca.crt
    Optional:                false
    DownwardAPI:             true
QoS Class:                   Burstable
Node-Selectors:              <none>
Tolerations:                 node.kubernetes.io/not-ready:NoExecute op=Exists for 300s
                             node.kubernetes.io/unreachable:NoExecute op=Exists for 300s
Events:
  Type     Reason     Age                   From               Message
  ----     ------     ----                  ----               -------
  Normal   Scheduled  6m9s                  default-scheduler  Successfully assigned default/busyboxpod to kind-control-plane
  Normal   Pulled     6m5s                  kubelet            Successfully pulled image "busybox" in 2.483s (2.483s including waiting)
  Normal   Pulled     6m1s                  kubelet            Successfully pulled image "busybox" in 2.296s (2.296s including waiting)
  Normal   Pulled     5m45s                 kubelet            Successfully pulled image "busybox" in 1.96s (1.96s including waiting)
  Normal   Created    5m15s (x4 over 6m5s)  kubelet            Created container busyboxpod
  Normal   Pulled     5m15s                 kubelet            Successfully pulled image "busybox" in 2.242s (2.242s including waiting)
  Normal   Started    5m13s (x4 over 6m4s)  kubelet            Started container busyboxpod
  Normal   Pulling    4m20s (x5 over 6m8s)  kubelet            Pulling image "busybox"
  Warning  BackOff    60s (x23 over 5m59s)  kubelet            Back-off restarting failed container busyboxpod in pod busyboxpod_default(3c4e2a9f-1dc5-41b2-91b6-d95fe3bb46d3)
rashmika@adsl-dynamic-ipv6:~/Documents/My_K8s_Projects/pods$ kubectl exec -it busyboxpod --bash
error: unknown flag: --bash
See 'kubectl exec --help' for usage.
rashmika@adsl-dynamic-ipv6:~/Documents/My_K8s_Projects/pods$ kubectl exec -it busyboxpod -- bash
error: unable to upgrade connection: container not found ("busyboxpod")
rashmika@adsl-dynamic-ipv6:~/Documents/My_K8s_Projects/pods$ kubectl exec -it busyboxpod-pod -- bash
Error from server (NotFound): pods "busyboxpod-pod" not found
rashmika@adsl-dynamic-ipv6:~/Documents/My_K8s_Projects/pods$ kubectl exec -it busyboxpod -- bash
error: unable to upgrade connection: container not found ("busyboxpod")
rashmika@adsl-dynamic-ipv6:~/Documents/My_K8s_Projects/pods$ kubectl get pod -o wide
NAME         READY   STATUS             RESTARTS       AGE   IP            NODE                 NOMINATED NODE   READINESS GATES
busyboxpod   0/1     CrashLoopBackOff   6 (4m1s ago)   10m   10.244.0.10   kind-control-plane   <none>           <none>
rashmika@adsl-dynamic-ipv6:~/Documents/My_K8s_Projects/pods$ kubectl exec -it busyboxpod -- bash
error: unable to upgrade connection: container not found ("busyboxpod")
rashmika@adsl-dynamic-ipv6:~/Documents/My_K8s_Projects/pods$ kubectl exec -it busyboxpod -- sh
error: unable to upgrade connection: container not found ("busyboxpod")
rashmika@adsl-dynamic-ipv6:~/Documents/My_K8s_Projects/pods$ kubectl logs busybox
error: error from server (NotFound): pods "busybox" not found in namespace "default"
rashmika@adsl-dynamic-ipv6:~/Documents/My_K8s_Projects/pods$ kubectl logs busyboxpod
rashmika@adsl-dynamic-ipv6:~/Documents/My_K8s_Projects/pods$ nano busybox.yaml
rashmika@adsl-dynamic-ipv6:~/Documents/My_K8s_Projects/pods$ kubectl exec -it busyboxpod -- bash
error: unable to upgrade connection: container not found ("busyboxpod")
rashmika@adsl-dynamic-ipv6:~/Documents/My_K8s_Projects/pods$ kubectl logs busyboxpod
rashmika@adsl-dynamic-ipv6:~/Documents/My_K8s_Projects/pods$ ll
total 4
-rw-r--r--. 1 rashmika rashmika 562 Jun 19 09:35 busybox.yaml
rashmika@adsl-dynamic-ipv6:~/Documents/My_K8s_Projects/pods$ kubectl exec -it busybox-pod -- bash
Error from server (NotFound): pods "busybox-pod" not found
rashmika@adsl-dynamic-ipv6:~/Documents/My_K8s_Projects/pods$ kubectl exec -it busybox-- bash
error: exec [POD] [COMMAND] is not supported anymore. Use exec [POD] -- [COMMAND] instead
See 'kubectl exec -h' for help and examples
rashmika@adsl-dynamic-ipv6:~/Documents/My_K8s_Projects/pods$ kubectl exec -it busybox -- bash
Error from server (NotFound): pods "busybox" not found
rashmika@adsl-dynamic-ipv6:~/Documents/My_K8s_Projects/pods$ kubectl exec -it busyboxpod -- bash

error: unable to upgrade connection: container not found ("busyboxpod")
rashmika@adsl-dynamic-ipv6:~/Documents/My_K8s_Projects/pods$ 
rashmika@adsl-dynamic-ipv6:~/Documents/My_K8s_Projects/pods$ nano busybox.yaml
rashmika@adsl-dynamic-ipv6:~/Documents/My_K8s_Projects/pods$ nano busybox.yaml
rashmika@adsl-dynamic-ipv6:~/Documents/My_K8s_Projects/pods$ kubectl exec -it busyboxpod -- bash

error: unable to upgrade connection: container not found ("busyboxpod")
rashmika@adsl-dynamic-ipv6:~/Documents/My_K8s_Projects/pods$ 
rashmika@adsl-dynamic-ipv6:~/Documents/My_K8s_Projects/pods$ kubectl exec -it busybox -- bash
Error from server (NotFound): pods "busybox" not found
rashmika@adsl-dynamic-ipv6:~/Documents/My_K8s_Projects/pods$ kubectl exec -it busyboxpod -- bash
error: unable to upgrade connection: container not found ("busyboxpod")
rashmika@adsl-dynamic-ipv6:~/Documents/My_K8s_Projects/pods$ kubectl get pods
NAME         READY   STATUS             RESTARTS      AGE
busyboxpod   0/1     CrashLoopBackOff   10 (3m ago)   29m
rashmika@adsl-dynamic-ipv6:~/Documents/My_K8s_Projects/pods$ kubectl logs busyboxpod
rashmika@adsl-dynamic-ipv6:~/Documents/My_K8s_Projects/pods$ nano busybox.yaml
rashmika@adsl-dynamic-ipv6:~/Documents/My_K8s_Projects/pods$ kubectl delete pod busyboxpod
pod "busyboxpod" deleted
rashmika@adsl-dynamic-ipv6:~/Documents/My_K8s_Projects/pods$ kubectl apply -f busyboxpod
error: the path "busyboxpod" does not exist
rashmika@adsl-dynamic-ipv6:~/Documents/My_K8s_Projects/pods$ kubectl apply -f busybox.yaml
pod/busyboxpod created
rashmika@adsl-dynamic-ipv6:~/Documents/My_K8s_Projects/pods$ kubectl get pods
NAME         READY   STATUS    RESTARTS   AGE
busyboxpod   1/1     Running   0          9s
rashmika@adsl-dynamic-ipv6:~/Documents/My_K8s_Projects/pods$ kubectl exec -it busyboxpod -- bash
error: Internal error occurred: error executing command in container: failed to exec in container: failed to start exec "42595e55233ba061ff079489cf96a651c797a6d713a17c9a91f085e4a1b642b4": OCI runtime exec failed: exec failed: unable to start container process: exec: "bash": executable file not found in $PATH: unknown
rashmika@adsl-dynamic-ipv6:~/Documents/My_K8s_Projects/pods$ kubectl get pods
NAME         READY   STATUS    RESTARTS   AGE
busyboxpod   1/1     Running   0          31s
rashmika@adsl-dynamic-ipv6:~/Documents/My_K8s_Projects/pods$ kubectl exec -it busyboxpod -- sh
/ # ll
sh: ll: not found
/ # ls
bin           etc           lib           proc          product_uuid  sys           usr
dev           home          lib64         product_name  root          tmp           var
/ # echo $DBCON
myconnectionstring
/ # exit
rashmika@adsl-dynamic-ipv6:~/Documents/My_K8s_Projects/pods$ nano busybox.yaml
rashmika@adsl-dynamic-ipv6:~/Documents/My_K8s_Projects/pods$ kubectl  delete busyboxpod
error: the server doesn't have a resource type "busyboxpod"
rashmika@adsl-dynamic-ipv6:~/Documents/My_K8s_Projects/pods$ kubectl delete busyboxpod
error: the server doesn't have a resource type "busyboxpod"
rashmika@adsl-dynamic-ipv6:~/Documents/My_K8s_Projects/pods$ kubectl delete pod  busyboxpod
pod "busyboxpod" deleted
rashmika@adsl-dynamic-ipv6:~/Documents/My_K8s_Projects/pods$ ^C
rashmika@adsl-dynamic-ipv6:~/Documents/My_K8s_Projects/pods$ ^C
rashmika@adsl-dynamic-ipv6:~/Documents/My_K8s_Projects/pods$ ^C
rashmika@adsl-dynamic-ipv6:~/Documents/My_K8s_Projects/pods$ ^C
rashmika@adsl-dynamic-ipv6:~/Documents/My_K8s_Projects/pods$ ^C
rashmika@adsl-dynamic-ipv6:~/Documents/My_K8s_Projects/pods$ kubectl run pod myapp --dry-run=client -o yaml
error: required flag(s) "image" not set
rashmika@adsl-dynamic-ipv6:~/Documents/My_K8s_Projects/pods$ kubectl run pod myapp --image=nginx --dry-run=client -o yaml
apiVersion: v1
kind: Pod
metadata:
  creationTimestamp: null
  labels:
    run: pod
  name: pod
spec:
  containers:
  - args:
    - myapp
    image: nginx
    name: pod
    resources: {}
  dnsPolicy: ClusterFirst
  restartPolicy: Always
status: {}
rashmika@adsl-dynamic-ipv6:~/Documents/My_K8s_Projects/pods$ ll
total 4
-rw-r--r--. 1 rashmika rashmika 559 Jun 19 09:44 busybox.yaml
rashmika@adsl-dynamic-ipv6:~/Documents/My_K8s_Projects/pods$ kubectl run pod myapp --image=nginx --dry-run=client -o yaml > myapp.yaml
rashmika@adsl-dynamic-ipv6:~/Documents/My_K8s_Projects/pods$ ll
total 8
-rw-r--r--. 1 rashmika rashmika 559 Jun 19 09:44 busybox.yaml
-rw-r--r--. 1 rashmika rashmika 248 Jun 19 17:21 myapp.yaml
rashmika@adsl-dynamic-ipv6:~/Documents/My_K8s_Projects/pods$ nano myapp.yaml
rashmika@adsl-dynamic-ipv6:~/Documents/My_K8s_Projects/pods$ kubectl create service myservice --dry-run=client -o yaml> myservice.yaml
error: unknown flag: --dry-run
See 'kubectl create service --help' for usage.
rashmika@adsl-dynamic-ipv6:~/Documents/My_K8s_Projects/pods$ kubectl run service myservice --dry-run=client -o yaml> myservice.yaml
error: required flag(s) "image" not set
rashmika@adsl-dynamic-ipv6:~/Documents/My_K8s_Projects/pods$ kubectl create service clusterip myservice --tcp=80 --dry-run=client -o yaml> myservice.yaml
rashmika@adsl-dynamic-ipv6:~/Documents/My_K8s_Projects/pods$ ll
total 12
-rw-r--r--. 1 rashmika rashmika 559 Jun 19 09:44 busybox.yaml
-rw-r--r--. 1 rashmika rashmika 559 Jun 19 17:23 myapp.yaml
-rw-r--r--. 1 rashmika rashmika 268 Jun 19 17:49 myservice.yaml
rashmika@adsl-dynamic-ipv6:~/Documents/My_K8s_Projects/pods$ mv myservice.yaml /Documents/My_K8s_Projects/services
mv: cannot stat '/Documents/My_K8s_Projects/services': Not a directory
rashmika@adsl-dynamic-ipv6:~/Documents/My_K8s_Projects/pods$ rm myservice.yaml
rashmika@adsl-dynamic-ipv6:~/Documents/My_K8s_Projects/pods$ ll
total 8
-rw-r--r--. 1 rashmika rashmika 559 Jun 19 09:44 busybox.yaml
-rw-r--r--. 1 rashmika rashmika 559 Jun 19 17:23 myapp.yaml
rashmika@adsl-dynamic-ipv6:~/Documents/My_K8s_Projects/pods$ cd ..
rashmika@adsl-dynamic-ipv6:~/Documents/My_K8s_Projects$ ll
total 0
drwxr-xr-x. 1 rashmika rashmika  0 Jun 18 13:15 configmaps
drwxr-xr-x. 1 rashmika rashmika 34 Jun 18 13:36 deployments
drwxr-xr-x. 1 rashmika rashmika 24 Jun 18 15:12 namespaces
drwxr-xr-x. 1 rashmika rashmika 44 Jun 19 17:52 pods
drwxr-xr-x. 1 rashmika rashmika  0 Jun 18 13:16 secrets
drwxr-xr-x. 1 rashmika rashmika  0 Jun 18 13:15 services
rashmika@adsl-dynamic-ipv6:~/Documents/My_K8s_Projects$ cd services
rashmika@adsl-dynamic-ipv6:~/Documents/My_K8s_Projects/services$ kubectl create service clusterip myservice --tcp=80:80 --dry-run=client -o yaml> myservice.yaml
rashmika@adsl-dynamic-ipv6:~/Documents/My_K8s_Projects/services$ ll
total 4
-rw-r--r--. 1 rashmika rashmika 269 Jun 19 17:53 myservice.yaml
rashmika@adsl-dynamic-ipv6:~/Documents/My_K8s_Projects/services$ 
rashmika@adsl-dynamic-ipv6:~/Documents/My_K8s_Projects/services$ cd..
bash: cd..: command not found...
^C
rashmika@adsl-dynamic-ipv6:~/Documents/My_K8s_Projects/services$ cd ..
rashmika@adsl-dynamic-ipv6:~/Documents/My_K8s_Projects$ cd pods
rashmika@adsl-dynamic-ipv6:~/Documents/My_K8s_Projects/pods$ cat myapp.yaml

.
.
.
.
.
.
.
.
.
.
.
.
.
apiVersion: v1
kind: Pod
metadata:
  creationTimestamp: null
  labels:
    run: busyboxpod
    app: busyboxpod
    type: front-end
  name: busyboxpod
spec:
  containers:
  - image: busybox
    name: busybox
    command: ["sleep", "3600"]
    resources:
      requests:
        cpu: 100m
        memory: 128Mi
      limits:
        cpu: 200m
        memory: 256Mi
    ports:
    - containerPort: 80
      name: http
      protocol: TCP
    env:
    -   name: DBCON
        value: myconnectionstring
  dnsPolicy: ClusterFirst
  restartPolicy: Always
status: {}
rashmika@adsl-dynamic-ipv6:~/Documents/My_K8s_Projects/pods$ 
.
.
.
.
.
.
.
.
.
apiVersion: v1
kind: Service
metadata:
  creationTimestamp: null
  labels:
    app: myservice
  name: myservice
spec:
  ports:
  - name: 80-80
    port: 80
    protocol: TCP
    targetPort: 80
  selector:
    app: busyboxpod
  type: front-end
status:
  loadBalancer: {}

.
.
.
.
.
.
.
.
apiVersion: v1
kind: Pod
metadata:
  creationTimestamp: null
  labels:
    run: busyboxpod
    app: busyboxpod
    type: ClusterIP
  name: busyboxpod
spec:
  containers:
  - image: busybox
    name: busybox
    command: ["sleep", "3600"]
    resources:
      requests:
        cpu: 100m
        memory: 128Mi
      limits:
	cpu: 200m
        memory: 256Mi
    ports:
    - containerPort: 80
      name: http
      protocol: TCP
    env:
    -   name: DBCON
        value: myconnectionstring
  dnsPolicy: ClusterFirst
  restartPolicy: Always
status: {}

.
.
..
.
.
.

.
..

..
apiVersion: v1
kind: Service
metadata:
  creationTimestamp: null
  labels:
    app: myservice
  name: myservice
spec:
  ports:
  - name: 80-80
    port: 80
    protocol: TCP
    targetPort: 80
  selector:
    app: myservice
  type: ClusterIP
status:
  loadBalancer: {}
.
.
.

.
.
..

.
apiVersion: v1
kind: Pod
metadata:
  creationTimestamp: null
  labels:
    run: busyboxpod
    app: busyboxpod
    type: front-end
  name: busyboxpod
spec:
  containers:
  - image: busybox
    name: busybox
    command: ["sleep", "3600"]
    resources:
      requests:
        cpu: 100m
        memory: 128Mi
      limits:
        cpu: 200m
        memory: 256Mi
    ports:
    - containerPort: 80
      name: http
      protocol: TCP
    env:
    -   name: DBCON
        value: myconnectionstring
  dnsPolicy: ClusterFirst
  restartPolicy: Always
status: {}
rashmika@adsl-dynamic-ipv6:~/Documents/My_K8s_Projects/pods$ kubectl apply -f myapp.yaml
pod/busyboxpod created
rashmika@adsl-dynamic-ipv6:~/Documents/My_K8s_Projects/pods$ kubectl get pod
NAME         READY   STATUS    RESTARTS   AGE
busyboxpod   1/1     Running   0          10s
rashmika@adsl-dynamic-ipv6:~/Documents/My_K8s_Projects/pods$ kubectl get pods
NAME         READY   STATUS    RESTARTS   AGE
busyboxpod   1/1     Running   0          18s
rashmika@adsl-dynamic-ipv6:~/Documents/My_K8s_Projects/pods$ ll
total 8
-rw-r--r--. 1 rashmika rashmika 559 Jun 19 09:44 busybox.yaml
-rw-r--r--. 1 rashmika rashmika 559 Jun 19 17:23 myapp.yaml
rashmika@adsl-dynamic-ipv6:~/Documents/My_K8s_Projects/pods$ nano myapp.yaml
rashmika@adsl-dynamic-ipv6:~/Documents/My_K8s_Projects/pods$ busybox.yaml
bash: busybox.yaml: command not found...
^[[Drashmika@adsl-dynamic-ipv6:~/Documents/My_K8s_Projects/pods$ nano busybox.yaml
rashmika@adsl-dynamic-ipv6:~/Documents/My_K8s_Projects/pods$ kubectl apply -f myservice.yaml
error: the path "myservice.yaml" does not exist
rashmika@adsl-dynamic-ipv6:~/Documents/My_K8s_Projects/pods$ kubectl apply -f /Documents/My_K8s_Projects/service/myservice.yaml
error: the path "/Documents/My_K8s_Projects/service/myservice.yaml" cannot be accessed: stat /Documents/My_K8s_Projects/service/myservice.yaml: not a directory
rashmika@adsl-dynamic-ipv6:~/Documents/My_K8s_Projects/pods$ kubectl apply -f /Documents/My_K8s_Projects/service/
error: the path "/Documents/My_K8s_Projects/service/" cannot be accessed: stat /Documents/My_K8s_Projects/service/: not a directory
rashmika@adsl-dynamic-ipv6:~/Documents/My_K8s_Projects/pods$ kubectl apply -f ~/Documents/My_K8s_Projects/service/myservice.yaml
error: the path "/home/rashmika/Documents/My_K8s_Projects/service/myservice.yaml" does not exist
rashmika@adsl-dynamic-ipv6:~/Documents/My_K8s_Projects/pods$ kubectl apply -f ~/Documents/My_K8s_Projects/services/myservice.yaml
service/myservice created
rashmika@adsl-dynamic-ipv6:~/Documents/My_K8s_Projects/pods$ kubectl get service
NAME         TYPE        CLUSTER-IP      EXTERNAL-IP   PORT(S)   AGE
kubernetes   ClusterIP   10.96.0.1       <none>        443/TCP   46h
myservice    ClusterIP   10.96.129.115   <none>        80/TCP    15s
rashmika@adsl-dynamic-ipv6:~/Documents/My_K8s_Projects/pods$ cat ~/Documents/My_K8s_Projects/services/myservice.yaml
apiVersion: v1
kind: Pod
metadata:
  creationTimestamp: null
  labels:
    run: busyboxpod
    app: busyboxpod
    type: front-end
  name: busyboxpod
spec:
  containers:
  - image: busybox
    name: busybox
    command: ["sleep", "3600"]
    resources:
      requests:
        cpu: 100m
        memory: 128Mi
      limits:
        cpu: 200m
        memory: 256Mi
    ports:
    - containerPort: 80
      name: http
      protocol: TCP
    env:
    -   name: DBCON
        value: myconnectionstring
  dnsPolicy: ClusterFirst
  restartPolicy: Always
status: {}
rashmika@adsl-dynamic-ipv6:~/Documents/My_K8s_Projects/pods$ kubectl apply -f myapp.yaml
pod/busyboxpod created
rashmika@adsl-dynamic-ipv6:~/Documents/My_K8s_Projects/pods$ kubectl get pod
NAME         READY   STATUS    RESTARTS   AGE
busyboxpod   1/1     Running   0          10s
rashmika@adsl-dynamic-ipv6:~/Documents/My_K8s_Projects/pods$ kubectl get pods
NAME         READY   STATUS    RESTARTS   AGE
busyboxpod   1/1     Running   0          18s
rashmika@adsl-dynamic-ipv6:~/Documents/My_K8s_Projects/pods$ ll
total 8
-rw-r--r--. 1 rashmika rashmika 559 Jun 19 09:44 busybox.yaml
-rw-r--r--. 1 rashmika rashmika 559 Jun 19 17:23 myapp.yaml
rashmika@adsl-dynamic-ipv6:~/Documents/My_K8s_Projects/pods$ nano myapp.yaml
rashmika@adsl-dynamic-ipv6:~/Documents/My_K8s_Projects/pods$ busybox.yaml
bash: busybox.yaml: command not found...
^[[Drashmika@adsl-dynamic-ipv6:~/Documents/My_K8s_Projects/pods$ nano busybox.yaml
rashmika@adsl-dynamic-ipv6:~/Documents/My_K8s_Projects/pods$ kubectl apply -f myservice.yaml
error: the path "myservice.yaml" does not exist
rashmika@adsl-dynamic-ipv6:~/Documents/My_K8s_Projects/pods$ kubectl apply -f /Documents/My_K8s_Projects/service/myservice.yaml
error: the path "/Documents/My_K8s_Projects/service/myservice.yaml" cannot be accessed: stat /Documents/My_K8s_Projects/service/myservice.yaml: not a directory
rashmika@adsl-dynamic-ipv6:~/Documents/My_K8s_Projects/pods$ kubectl apply -f /Documents/My_K8s_Projects/service/
error: the path "/Documents/My_K8s_Projects/service/" cannot be accessed: stat /Documents/My_K8s_Projects/service/: not a directory
rashmika@adsl-dynamic-ipv6:~/Documents/My_K8s_Projects/pods$ kubectl apply -f ~/Documents/My_K8s_Projects/service/myservice.yaml
error: the path "/home/rashmika/Documents/My_K8s_Projects/service/myservice.yaml" does not exist
rashmika@adsl-dynamic-ipv6:~/Documents/My_K8s_Projects/pods$ kubectl apply -f ~/Documents/My_K8s_Projects/services/myservice.yaml
service/myservice created
rashmika@adsl-dynamic-ipv6:~/Documents/My_K8s_Projects/pods$ kubectl get service
NAME         TYPE        CLUSTER-IP      EXTERNAL-IP   PORT(S)   AGE
kubernetes   ClusterIP   10.96.0.1       <none>        443/TCP   46h
myservice    ClusterIP   10.96.129.115   <none>        80/TCP    15s
rashmika@adsl-dynamic-ipv6:~/Documents/My_K8s_Projects/pods$ cat ~/Documents/My_K8s_Projects/services/myservice.yaml
apiVersion: v1
kind: Service
metadata:
  creationTimestamp: null
  labels:
    app: myservice
  name: myservice
spec:
  ports:
  - name: 80-80
    port: 80
    protocol: TCP
    targetPort: 80
  selector:
    app: myservice
  type: ClusterIP
status:
  loadBalancer: {}
rashmika@adsl-dynamic-ipv6:~/Documents/My_K8s_Projects/pods$ kubectl get po -o wide
NAME         READY   STATUS    RESTARTS   AGE   IP            NODE                 NOMINATED NODE   READINESS GATES
busyboxpod   1/1     Running   0          24m   10.244.0.12   kind-control-plane   <none>           <none>
rashmika@adsl-dynamic-ipv6:~/Documents/My_K8s_Projects/pods$ kubectl get ep myservice
NAME        ENDPOINTS   AGE
myservice   <none>      18m
rashmika@adsl-dynamic-ipv6:~/Documents/My_K8s_Projects/pods$ kubectl get ep myservice

NAME        ENDPOINTS   AGE
myservice   <none>      19m
rashmika@adsl-dynamic-ipv6:~/Documents/My_K8s_Projects/pods$ 
rashmika@adsl-dynamic-ipv6:~/Documents/My_K8s_Projects/pods$ nano busybox.yaml
rashmika@adsl-dynamic-ipv6:~/Documents/My_K8s_Projects/pods$ nano myapp.yaml
rashmika@adsl-dynamic-ipv6:~/Documents/My_K8s_Projects/pods$ nano myservice.yaml
rashmika@adsl-dynamic-ipv6:~/Documents/My_K8s_Projects/pods$ cd ..
rashmika@adsl-dynamic-ipv6:~/Documents/My_K8s_Projects$ cd services
rashmika@adsl-dynamic-ipv6:~/Documents/My_K8s_Projects/services$ ll
total 4
-rw-r--r--. 1 rashmika rashmika 269 Jun 19 17:53 myservice.yaml
rashmika@adsl-dynamic-ipv6:~/Documents/My_K8s_Projects/services$ nano myservice.yaml
rashmika@adsl-dynamic-ipv6:~/Documents/My_K8s_Projects/services$ cat myservice.yaml
apiVersion: v1
kind: Service
metadata:
  creationTimestamp: null
  labels:
    app: myservice
  name: myservice
spec:
  ports:
  - name: 80-80
    port: 80
    protocol: TCP
    targetPort: 80
  selector:
    app: busyboxpod
  type: front-end
status:
  loadBalancer: {}
rashmika@adsl-dynamic-ipv6:~/Documents/My_K8s_Projects/services$ kubectl get po -o wide
NAME         READY   STATUS    RESTARTS   AGE   IP            NODE                 NOMINATED NODE   READINESS GATES
busyboxpod   1/1     Running   0          30m   10.244.0.12   kind-control-plane   <none>           <none>
rashmika@adsl-dynamic-ipv6:~/Documents/My_K8s_Projects/services$ kubectl get ep myservice
NAME        ENDPOINTS   AGE
myservice   <none>      23m
rashmika@adsl-dynamic-ipv6:~/Documents/My_K8s_Projects/services$ kubectl delete service myservice
service "myservice" deleted
rashmika@adsl-dynamic-ipv6:~/Documents/My_K8s_Projects/services$ kubectl apply -f myservice.yaml
The Service "myservice" is invalid: spec.type: Unsupported value: "front-end": supported values: "ClusterIP", "ExternalName", "LoadBalancer", "NodePort"
rashmika@adsl-dynamic-ipv6:~/Documents/My_K8s_Projects/services$ nano myservice.yaml
rashmika@adsl-dynamic-ipv6:~/Documents/My_K8s_Projects/services$ kubectl apply -f myservice.yaml
service/myservice created
rashmika@adsl-dynamic-ipv6:~/Documents/My_K8s_Projects/services$ cd ..
rashmika@adsl-dynamic-ipv6:~/Documents/My_K8s_Projects$ cd pods
rashmika@adsl-dynamic-ipv6:~/Documents/My_K8s_Projects/pods$ ll
total 8
-rw-r--r--. 1 rashmika rashmika 559 Jun 19 09:44 busybox.yaml
-rw-r--r--. 1 rashmika rashmika 559 Jun 19 17:23 myapp.yaml
rashmika@adsl-dynamic-ipv6:~/Documents/My_K8s_Projects/pods$ nano myapp.yaml
rashmika@adsl-dynamic-ipv6:~/Documents/My_K8s_Projects/pods$ kubectl apply -f myapp.yaml
pod/busyboxpod configured
rashmika@adsl-dynamic-ipv6:~/Documents/My_K8s_Projects/pods$ kubectl get po -o wide
NAME         READY   STATUS    RESTARTS   AGE   IP            NODE                 NOMINATED NODE   READINESS GATES
busyboxpod   1/1     Running   0          34m   10.244.0.12   kind-control-plane   <none>           <none>
rashmika@adsl-dynamic-ipv6:~/Documents/My_K8s_Projects/pods$ kubectl get ep myservice
NAME        ENDPOINTS        AGE
myservice   10.244.0.12:80   93s
rashmika@adsl-dynamic-ipv6:~/Documents/My_K8s_Projects/pods$ kubectl get nodes
NAME                 STATUS   ROLES           AGE   VERSION
kind-control-plane   Ready    control-plane   47h   v1.29.2
rashmika@adsl-dynamic-ipv6:~/Documents/My_K8s_Projects/pods$ kubectl get nodes --all-namespaces
NAME                 STATUS   ROLES           AGE   VERSION
kind-control-plane   Ready    control-plane   2d    v1.29.2
rashmika@adsl-dynamic-ipv6:~/Documents/My_K8s_Projects/pods$ kubectl get nodes -o wide --all-namespaces
NAME                 STATUS   ROLES           AGE   VERSION   INTERNAL-IP   EXTERNAL-IP   OS-IMAGE                         KERNEL-VERSION           CONTAINER-RUNTIME
kind-control-plane   Ready    control-plane   2d    v1.29.2   172.18.0.2    <none>        Debian GNU/Linux 12 (bookworm)   6.14.9-300.fc42.x86_64   containerd://1.7.13
rashmika@adsl-dynamic-ipv6:~/Documents/My_K8s_Projects/pods$ nano myapp.yaml
rashmika@adsl-dynamic-ipv6:~/Documents/My_K8s_Projects/pods$ kubectl run pod two-containers --image=nginx --tcp=80 --image=busybox --tcp=81 --dry-run=client -o yaml > twocontainers.yaml 
error: unknown flag: --tcp
See 'kubectl run --help' for usage.
rashmika@adsl-dynamic-ipv6:~/Documents/My_K8s_Projects/pods$ kubectl run pod two-containers --image=nginx --tcp=80:80 --image=busybox --tcp=81:81 --dry-run=client -o yaml > twocontainers.yaml 
error: unknown flag: --tcp
See 'kubectl run --help' for usage.
rashmika@adsl-dynamic-ipv6:~/Documents/My_K8s_Projects/pods$ kubectl run pod two-containers --image=nginx --tcp=80:80 --dry-run=client -o yaml > twocontainers.yaml 
error: unknown flag: --tcp
See 'kubectl run --help' for usage.
rashmika@adsl-dynamic-ipv6:~/Documents/My_K8s_Projects/pods$ kubectl run pod two-containers --image=nginx --image=busybox --dry-run=client -o yaml > twocontainers.yaml 
rashmika@adsl-dynamic-ipv6:~/Documents/My_K8s_Projects/pods$ kubectl get pods
NAME         READY   STATUS    RESTARTS      AGE
busyboxpod   1/1     Running   5 (31m ago)   5h32m
rashmika@adsl-dynamic-ipv6:~/Documents/My_K8s_Projects/pods$ kubectl run pod two-containers --image=nginx --dry-run=client -o yaml > twocontainers.yaml 
rashmika@adsl-dynamic-ipv6:~/Documents/My_K8s_Projects/pods$ kubectl get pods
NAME         READY   STATUS    RESTARTS      AGE
busyboxpod   1/1     Running   5 (32m ago)   5h32m
rashmika@adsl-dynamic-ipv6:~/Documents/My_K8s_Projects/pods$ kubectl run pod two-containers --image=nginx --dry-run=client -o yaml > twocontainers.yaml 
rashmika@adsl-dynamic-ipv6:~/Documents/My_K8s_Projects/pods$ kubectl get pods
NAME         READY   STATUS    RESTARTS      AGE
busyboxpod   1/1     Running   5 (39m ago)   5h40m
rashmika@adsl-dynamic-ipv6:~/Documents/My_K8s_Projects/pods$ kubectl run pod twocontainers --image=nginx --dry-run=client -o yaml > twocontainers.yaml 
rashmika@adsl-dynamic-ipv6:~/Documents/My_K8s_Projects/pods$ kubectl get pods
NAME         READY   STATUS    RESTARTS      AGE
busyboxpod   1/1     Running   5 (40m ago)   5h40m
rashmika@adsl-dynamic-ipv6:~/Documents/My_K8s_Projects/pods$ ll
total 12
-rw-r--r--. 1 rashmika rashmika 559 Jun 19 09:44 busybox.yaml
-rw-r--r--. 1 rashmika rashmika 560 Jun 20 11:01 myapp.yaml
-rw-r--r--. 1 rashmika rashmika 256 Jun 20 16:09 twocontainers.yaml
rashmika@adsl-dynamic-ipv6:~/Documents/My_K8s_Projects/pods$ nano twocontainers.yaml
rashmika@adsl-dynamic-ipv6:~/Documents/My_K8s_Projects/pods$ nano twocontainers.yaml
rashmika@adsl-dynamic-ipv6:~/Documents/My_K8s_Projects/pods$ nano twocontainers.yaml
rashmika@adsl-dynamic-ipv6:~/Documents/My_K8s_Projects/pods$ nano twocontainers.yaml
rashmika@adsl-dynamic-ipv6:~/Documents/My_K8s_Projects/pods$ nano twocontainers.yaml
rashmika@adsl-dynamic-ipv6:~/Documents/My_K8s_Projects/pods$ nano twocontainers.yaml
rashmika@adsl-dynamic-ipv6:~/Documents/My_K8s_Projects/pods$ kubectl apply -f twocontainers.yaml
pod/twocontainers created
rashmika@adsl-dynamic-ipv6:~/Documents/My_K8s_Projects/pods$ kubectl get pods
NAME            READY   STATUS    RESTARTS      AGE
busyboxpod      1/1     Running   6 (28m ago)   6h29m
twocontainers   2/2     Running   0             29s
rashmika@adsl-dynamic-ipv6:~/Documents/My_K8s_Projects/pods$ kubectl get pods -o wide
NAME            READY   STATUS    RESTARTS      AGE     IP            NODE                 NOMINATED NODE   READINESS GATES
busyboxpod      1/1     Running   6 (28m ago)   6h29m   10.244.0.12   kind-control-plane   <none>           <none>
twocontainers   2/2     Running   0             44s     10.244.0.13   kind-control-plane   <none>           <none>
rashmika@adsl-dynamic-ipv6:~/Documents/My_K8s_Projects/pods$ 


.
.
.
.
.
.
.
.
.

.
.
.
.
.
.
.
.
.
.
rashmika@adsl-dynamic-ipv6:~$ docker countainer ls
docker: unknown command: docker countainer

Run 'docker --help' for more information
rashmika@adsl-dynamic-ipv6:~$ docker container ls
CONTAINER ID   IMAGE                  COMMAND                  CREATED      STATUS         PORTS                       NAMES
c6ebe07cd850   kindest/node:v1.29.2   "/usr/local/bin/entr…"   5 days ago   Up 3 minutes   127.0.0.1:33561->6443/tcp   kind-control-plane
rashmika@adsl-dynamic-ipv6:~$ docker container ls -a
CONTAINER ID   IMAGE                                 COMMAND                  CREATED             STATUS                         PORTS                       NAMES
01b67c3ff8ae   alpine                                "/bin/sh"                49 minutes ago      Exited (0) 42 minutes ago                                  my-alpine-version
dc72e5c87345   alpine:latest                         "/bin/sh"                About an hour ago   Exited (0) About an hour ago                               intelligent_mcnulty
06a48006f4d9   hello-world                           "/hello"                 2 hours ago         Exited (0) 2 hours ago                                     magical_kepler
71772759fab1   hello-world                           "/hello"                 2 hours ago         Exited (0) 2 hours ago                                     bold_franklin
c6ebe07cd850   kindest/node:v1.29.2                  "/usr/local/bin/entr…"   5 days ago          Up 3 minutes                   127.0.0.1:33561->6443/tcp   kind-control-plane
3782424a3812   gcr.io/k8s-minikube/kicbase:v0.0.47   "/usr/local/bin/entr…"   11 days ago         Exited (130) 4 days ago                                    minikube
5368d41673d6   nginx:latest                          "/docker-entrypoint.…"   2 weeks ago         Exited (0) 11 days ago                                     devtest1
874fa916beb8   nginx                                 "/docker-entrypoint.…"   2 weeks ago         Exited (0) 2 weeks ago                                     dazzling_bouman
2e8a9037a6ed   nginx                                 "/docker-entrypoint.…"   2 weeks ago         Exited (0) 2 weeks ago                                     boring_cray
79fb67a33490   nginx                                 "/docker-entrypoint.…"   2 weeks ago         Exited (0) 11 days ago                                     webserver
4fc1c4c5be12   nginx                                 "/docker-entrypoint.…"   2 weeks ago         Exited (0) 2 weeks ago                                     adoring_knuth
c59c046016d2   nginx                                 "/docker-entrypoint.…"   2 weeks ago         Exited (127) 2 weeks ago                                   boring_hodgkin
03fefa750bb8   nginx                                 "/docker-entrypoint.…"   2 weeks ago         Exited (0) 2 weeks ago                                     optimistic_mcnulty
c2c0bf89a5a9   nginx                                 "/docker-entrypoint.…"   2 weeks ago         Exited (0) 2 weeks ago                                     wizardly_jennings
1362307064d8   hello-world                           "/hello"                 2 weeks ago         Exited (0) 2 weeks ago                                     dreamy_galileo
rashmika@adsl-dynamic-ipv6:~$ docker container run --name=my-alpine-version2 -it alpine /bin/sh
/ # ls
bin    dev    etc    home   lib    media  mnt    opt    proc   root   run    sbin   srv    sys    tmp    usr    var
/ # uname -a
Linux d45fe2e914c6 6.14.11-300.fc42.x86_64 #1 SMP PREEMPT_DYNAMIC Tue Jun 10 16:24:16 UTC 2025 x86_64 Linux
/ # if config
> ^C

/ # ifconfig
eth0      Link encap:Ethernet  HWaddr 1E:C1:57:63:DE:32  
          inet addr:172.17.0.2  Bcast:172.17.255.255  Mask:255.255.0.0
          UP BROADCAST RUNNING MULTICAST  MTU:1500  Metric:1
          RX packets:48 errors:0 dropped:0 overruns:0 frame:0
          TX packets:3 errors:0 dropped:0 overruns:0 carrier:0
          collisions:0 txqueuelen:0 
          RX bytes:6810 (6.6 KiB)  TX bytes:126 (126.0 B)

lo        Link encap:Local Loopback  
          inet addr:127.0.0.1  Mask:255.0.0.0
          inet6 addr: ::1/128 Scope:Host
          UP LOOPBACK RUNNING  MTU:65536  Metric:1
          RX packets:0 errors:0 dropped:0 overruns:0 frame:0
          TX packets:0 errors:0 dropped:0 overruns:0 carrier:0
          collisions:0 txqueuelen:1000 
          RX bytes:0 (0.0 B)  TX bytes:0 (0.0 B)

/ # exit
rashmika@adsl-dynamic-ipv6:~$ uname -a
Linux adsl-dynamic-ipv6.slt.lk 6.14.11-300.fc42.x86_64 #1 SMP PREEMPT_DYNAMIC Tue Jun 10 16:24:16 UTC 2025 x86_64 GNU/Linux
rashmika@adsl-dynamic-ipv6:~$ docker container ls
CONTAINER ID   IMAGE                  COMMAND                  CREATED      STATUS         PORTS                       NAMES
c6ebe07cd850   kindest/node:v1.29.2   "/usr/local/bin/entr…"   5 days ago   Up 8 minutes   127.0.0.1:33561->6443/tcp   kind-control-plane
rashmika@adsl-dynamic-ipv6:~$ docker container ls -a
CONTAINER ID   IMAGE                                 COMMAND                  CREATED             STATUS                         PORTS                       NAMES
d45fe2e914c6   alpine                                "/bin/sh"                2 minutes ago       Exited (0) 2 minutes ago                                   my-alpine-version2
01b67c3ff8ae   alpine                                "/bin/sh"                54 minutes ago      Exited (0) 47 minutes ago                                  my-alpine-version
dc72e5c87345   alpine:latest                         "/bin/sh"                About an hour ago   Exited (0) About an hour ago                               intelligent_mcnulty
06a48006f4d9   hello-world                           "/hello"                 2 hours ago         Exited (0) 2 hours ago                                     magical_kepler
71772759fab1   hello-world                           "/hello"                 3 hours ago         Exited (0) 3 hours ago                                     bold_franklin
c6ebe07cd850   kindest/node:v1.29.2                  "/usr/local/bin/entr…"   5 days ago          Up 8 minutes                   127.0.0.1:33561->6443/tcp   kind-control-plane
3782424a3812   gcr.io/k8s-minikube/kicbase:v0.0.47   "/usr/local/bin/entr…"   11 days ago         Exited (130) 4 days ago                                    minikube
5368d41673d6   nginx:latest                          "/docker-entrypoint.…"   2 weeks ago         Exited (0) 11 days ago                                     devtest1
874fa916beb8   nginx                                 "/docker-entrypoint.…"   2 weeks ago         Exited (0) 2 weeks ago                                     dazzling_bouman
2e8a9037a6ed   nginx                                 "/docker-entrypoint.…"   2 weeks ago         Exited (0) 2 weeks ago                                     boring_cray
79fb67a33490   nginx                                 "/docker-entrypoint.…"   2 weeks ago         Exited (0) 11 days ago                                     webserver
4fc1c4c5be12   nginx                                 "/docker-entrypoint.…"   2 weeks ago         Exited (0) 2 weeks ago                                     adoring_knuth
c59c046016d2   nginx                                 "/docker-entrypoint.…"   2 weeks ago         Exited (127) 2 weeks ago                                   boring_hodgkin
03fefa750bb8   nginx                                 "/docker-entrypoint.…"   2 weeks ago         Exited (0) 2 weeks ago                                     optimistic_mcnulty
c2c0bf89a5a9   nginx                                 "/docker-entrypoint.…"   2 weeks ago         Exited (0) 2 weeks ago                                     wizardly_jennings
1362307064d8   hello-world                           "/hello"                 2 weeks ago         Exited (0) 2 weeks ago                                     dreamy_galileo
rashmika@adsl-dynamic-ipv6:~$ docker container run --name=my-live-alpine -dil alpine /bin/ash
docker: invalid reference format

Run 'docker run --help' for more information
rashmika@adsl-dynamic-ipv6:~$ docker container run --name my-live-alpine -dil alpine /bin/ash
docker: invalid reference format

Run 'docker run --help' for more information
rashmika@adsl-dynamic-ipv6:~$ docker container run --name my-live-alpine -dit alpine /bin/ash
36d9acb76f5a617758ddb0507ab60ff4b209aa2f649ebae7594feec76ed2100a
rashmika@adsl-dynamic-ipv6:~$ docker container ls

CONTAINER ID   IMAGE                  COMMAND                  CREATED         STATUS          PORTS                       NAMES
36d9acb76f5a   alpine                 "/bin/ash"               7 seconds ago   Up 7 seconds                                my-live-alpine
c6ebe07cd850   kindest/node:v1.29.2   "/usr/local/bin/entr…"   5 days ago      Up 14 minutes   127.0.0.1:33561->6443/tcp   kind-control-plane
rashmika@adsl-dynamic-ipv6:~$ 
rashmika@adsl-dynamic-ipv6:~$ docker container ls -a
CONTAINER ID   IMAGE                                 COMMAND                  CREATED          STATUS                      PORTS                       NAMES
36d9acb76f5a   alpine                                "/bin/ash"               12 seconds ago   Up 12 seconds                                           my-live-alpine
d45fe2e914c6   alpine                                "/bin/sh"                8 minutes ago    Exited (0) 7 minutes ago                                my-alpine-version2
01b67c3ff8ae   alpine                                "/bin/sh"                59 minutes ago   Exited (0) 53 minutes ago                               my-alpine-version
dc72e5c87345   alpine:latest                         "/bin/sh"                2 hours ago      Exited (0) 2 hours ago                                  intelligent_mcnulty
06a48006f4d9   hello-world                           "/hello"                 2 hours ago      Exited (0) 2 hours ago                                  magical_kepler
71772759fab1   hello-world                           "/hello"                 3 hours ago      Exited (0) 3 hours ago                                  bold_franklin
c6ebe07cd850   kindest/node:v1.29.2                  "/usr/local/bin/entr…"   5 days ago       Up 14 minutes               127.0.0.1:33561->6443/tcp   kind-control-plane
3782424a3812   gcr.io/k8s-minikube/kicbase:v0.0.47   "/usr/local/bin/entr…"   11 days ago      Exited (130) 4 days ago                                 minikube
5368d41673d6   nginx:latest                          "/docker-entrypoint.…"   2 weeks ago      Exited (0) 11 days ago                                  devtest1
874fa916beb8   nginx                                 "/docker-entrypoint.…"   2 weeks ago      Exited (0) 2 weeks ago                                  dazzling_bouman
2e8a9037a6ed   nginx                                 "/docker-entrypoint.…"   2 weeks ago      Exited (0) 2 weeks ago                                  boring_cray
79fb67a33490   nginx                                 "/docker-entrypoint.…"   2 weeks ago      Exited (0) 11 days ago                                  webserver
4fc1c4c5be12   nginx                                 "/docker-entrypoint.…"   2 weeks ago      Exited (0) 2 weeks ago                                  adoring_knuth
c59c046016d2   nginx                                 "/docker-entrypoint.…"   2 weeks ago      Exited (127) 2 weeks ago                                boring_hodgkin
03fefa750bb8   nginx                                 "/docker-entrypoint.…"   2 weeks ago      Exited (0) 2 weeks ago                                  optimistic_mcnulty
c2c0bf89a5a9   nginx                                 "/docker-entrypoint.…"   2 weeks ago      Exited (0) 2 weeks ago                                  wizardly_jennings
1362307064d8   hello-world                           "/hello"                 2 weeks ago      Exited (0) 2 weeks ago                                  dreamy_galileo
rashmika@adsl-dynamic-ipv6:~$ docker container run --help
Usage:  docker container run [OPTIONS] IMAGE [COMMAND] [ARG...]

Create and run a new container from an image

Aliases:
  docker container run, docker run

Options:
      --add-host list                    Add a custom host-to-IP mapping (host:ip)
      --annotation map                   Add an annotation to the container (passed through to the OCI runtime) (default map[])
  -a, --attach list                      Attach to STDIN, STDOUT or STDERR
      --blkio-weight uint16              Block IO (relative weight), between 10 and 1000, or 0 to disable (default 0)
      --blkio-weight-device list         Block IO weight (relative device weight) (default [])
      --cap-add list                     Add Linux capabilities
      --cap-drop list                    Drop Linux capabilities
      --cgroup-parent string             Optional parent cgroup for the container
      --cgroupns string                  Cgroup namespace to use (host|private)
                                         'host':    Run the container in the Docker host's cgroup namespace
                                         'private': Run the container in its own private cgroup namespace
                                         '':        Use the cgroup namespace as configured by the
                                                    default-cgroupns-mode option on the daemon (default)
      --cidfile string                   Write the container ID to the file
      --cpu-period int                   Limit CPU CFS (Completely Fair Scheduler) period
      --cpu-quota int                    Limit CPU CFS (Completely Fair Scheduler) quota
      --cpu-rt-period int                Limit CPU real-time period in microseconds
      --cpu-rt-runtime int               Limit CPU real-time runtime in microseconds
  -c, --cpu-shares int                   CPU shares (relative weight)
      --cpus decimal                     Number of CPUs
      --cpuset-cpus string               CPUs in which to allow execution (0-3, 0,1)
      --cpuset-mems string               MEMs in which to allow execution (0-3, 0,1)
  -d, --detach                           Run container in background and print container ID
      --detach-keys string               Override the key sequence for detaching a container
      --device list                      Add a host device to the container
      --device-cgroup-rule list          Add a rule to the cgroup allowed devices list
      --device-read-bps list             Limit read rate (bytes per second) from a device (default [])
      --device-read-iops list            Limit read rate (IO per second) from a device (default [])
      --device-write-bps list            Limit write rate (bytes per second) to a device (default [])
      --device-write-iops list           Limit write rate (IO per second) to a device (default [])
      --disable-content-trust            Skip image verification (default true)
      --dns list                         Set custom DNS servers
      --dns-option list                  Set DNS options
      --dns-search list                  Set custom DNS search domains
      --domainname string                Container NIS domain name
      --entrypoint string                Overwrite the default ENTRYPOINT of the image
  -e, --env list                         Set environment variables
      --env-file list                    Read in a file of environment variables
      --expose list                      Expose a port or a range of ports
      --gpus gpu-request                 GPU devices to add to the container ('all' to pass all GPUs)
      --group-add list                   Add additional groups to join
      --health-cmd string                Command to run to check health
      --health-interval duration         Time between running the check (ms|s|m|h) (default 0s)
      --health-retries int               Consecutive failures needed to report unhealthy
      --health-start-interval duration   Time between running the check during the start period (ms|s|m|h) (default 0s)
      --health-start-period duration     Start period for the container to initialize before starting health-retries countdown (ms|s|m|h)
                                         (default 0s)
      --health-timeout duration          Maximum time to allow one check to run (ms|s|m|h) (default 0s)
      --help                             Print usage
  -h, --hostname string                  Container host name
      --init                             Run an init inside the container that forwards signals and reaps processes
  -i, --interactive                      Keep STDIN open even if not attached
      --ip string                        IPv4 address (e.g., 172.30.100.104)
      --ip6 string                       IPv6 address (e.g., 2001:db8::33)
      --ipc string                       IPC mode to use
      --isolation string                 Container isolation technology
      --kernel-memory bytes              Kernel memory limit
  -l, --label list                       Set meta data on a container
      --label-file list                  Read in a line delimited file of labels
      --link list                        Add link to another container
      --link-local-ip list               Container IPv4/IPv6 link-local addresses
      --log-driver string                Logging driver for the container
      --log-opt list                     Log driver options
      --mac-address string               Container MAC address (e.g., 92:d0:c6:0a:29:33)
  -m, --memory bytes                     Memory limit
      --memory-reservation bytes         Memory soft limit
      --memory-swap bytes                Swap limit equal to memory plus swap: '-1' to enable unlimited swap
      --memory-swappiness int            Tune container memory swappiness (0 to 100) (default -1)
      --mount mount                      Attach a filesystem mount to the container
      --name string                      Assign a name to the container
      --network network                  Connect a container to a network
      --network-alias list               Add network-scoped alias for the container
      --no-healthcheck                   Disable any container-specified HEALTHCHECK
      --oom-kill-disable                 Disable OOM Killer
      --oom-score-adj int                Tune host's OOM preferences (-1000 to 1000)
      --pid string                       PID namespace to use
      --pids-limit int                   Tune container pids limit (set -1 for unlimited)
      --platform string                  Set platform if server is multi-platform capable
      --privileged                       Give extended privileges to this container
  -p, --publish list                     Publish a container's port(s) to the host
  -P, --publish-all                      Publish all exposed ports to random ports
      --pull string                      Pull image before running ("always", "missing", "never") (default "missing")
  -q, --quiet                            Suppress the pull output
      --read-only                        Mount the container's root filesystem as read only
      --restart string                   Restart policy to apply when a container exits (default "no")
      --rm                               Automatically remove the container and its associated anonymous volumes when it exits
      --runtime string                   Runtime to use for this container
      --security-opt list                Security Options
      --shm-size bytes                   Size of /dev/shm
      --sig-proxy                        Proxy received signals to the process (default true)
      --stop-signal string               Signal to stop the container
      --stop-timeout int                 Timeout (in seconds) to stop a container
      --storage-opt list                 Storage driver options for the container
      --sysctl map                       Sysctl options (default map[])
      --tmpfs list                       Mount a tmpfs directory
  -t, --tty                              Allocate a pseudo-TTY
      --ulimit ulimit                    Ulimit options (default [])
      --use-api-socket                   Bind mount Docker API socket and required auth
  -u, --user string                      Username or UID (format: <name|uid>[:<group|gid>])
      --userns string                    User namespace to use
      --uts string                       UTS namespace to use
  -v, --volume list                      Bind mount a volume
      --volume-driver string             Optional volume driver for the container
      --volumes-from list                Mount volumes from the specified container(s)
  -w, --workdir string                   Working directory inside the container
rashmika@adsl-dynamic-ipv6:~$ docker container ls
CONTAINER ID   IMAGE                  COMMAND                  CREATED         STATUS          PORTS                       NAMES
36d9acb76f5a   alpine                 "/bin/ash"               9 minutes ago   Up 9 minutes                                my-live-alpine
c6ebe07cd850   kindest/node:v1.29.2   "/usr/local/bin/entr…"   5 days ago      Up 23 minutes   127.0.0.1:33561->6443/tcp   kind-control-plane
rashmika@adsl-dynamic-ipv6:~$ docker container exec 36d9acb76f5a
docker: 'docker container exec' requires at least 2 arguments

Usage:  docker container exec [OPTIONS] CONTAINER COMMAND [ARG...]

See 'docker container exec --help' for more information
rashmika@adsl-dynamic-ipv6:~$ docker container exec 36d9acb76f5a hostname
36d9acb76f5a
rashmika@adsl-dynamic-ipv6:~$ docker container exec 36d9acb76f5a image
OCI runtime exec failed: exec failed: unable to start container process: exec: "image": executable file not found in $PATH: unknown
rashmika@adsl-dynamic-ipv6:~$ docker container exec 36d9acb76f5a ls
bin
dev
etc
home
lib
media
mnt
opt
proc
root
run
sbin
srv
sys
tmp
usr
var
rashmika@adsl-dynamic-ipv6:~$ docker container exec 36d9acb76f5a ifconfig
eth0      Link encap:Ethernet  HWaddr 76:B6:1A:B6:A1:C4  
          inet addr:172.17.0.2  Bcast:172.17.255.255  Mask:255.255.0.0
          UP BROADCAST RUNNING MULTICAST  MTU:1500  Metric:1
          RX packets:30 errors:0 dropped:0 overruns:0 frame:0
          TX packets:3 errors:0 dropped:0 overruns:0 carrier:0
          collisions:0 txqueuelen:0 
          RX bytes:3883 (3.7 KiB)  TX bytes:126 (126.0 B)

lo        Link encap:Local Loopback  
          inet addr:127.0.0.1  Mask:255.0.0.0
          inet6 addr: ::1/128 Scope:Host
          UP LOOPBACK RUNNING  MTU:65536  Metric:1
          RX packets:0 errors:0 dropped:0 overruns:0 frame:0
          TX packets:0 errors:0 dropped:0 overruns:0 carrier:0
          collisions:0 txqueuelen:1000 
          RX bytes:0 (0.0 B)  TX bytes:0 (0.0 B)

rashmika@adsl-dynamic-ipv6:~$ docker container run my-live-alpine
Unable to find image 'my-live-alpine:latest' locally
docker: Error response from daemon: pull access denied for my-live-alpine, repository does not exist or may require 'docker login': denied: requested access to the resource is denied

Run 'docker run --help' for more information
rashmika@adsl-dynamic-ipv6:~$ docker container exec my-live-alpine
docker: 'docker container exec' requires at least 2 arguments

Usage:  docker container exec [OPTIONS] CONTAINER COMMAND [ARG...]

See 'docker container exec --help' for more information
rashmika@adsl-dynamic-ipv6:~$ 
rashmika@adsl-dynamic-ipv6:~$ docker container run my-live-alpine -it alpine /bin/s 
Unable to find image 'my-live-alpine:latest' locally
^[[Adocker: Error response from daemon: pull access denied for my-live-alpine, repository does not exist or may require 'docker login': denied: requested access to the resource is denied

Run 'docker run --help' for more information
rashmika@adsl-dynamic-ipv6:~$ docker container run my-live-alpine -it alpine /bin/s ^C
rashmika@adsl-dynamic-ipv6:~$ docker container run my-live-alpine -it alpine /bin/ash
Unable to find image 'my-live-alpine:latest' locally
docker: Error response from daemon: pull access denied for my-live-alpine, repository does not exist or may require 'docker login': denied: requested access to the resource is denied

Run 'docker run --help' for more information
rashmika@adsl-dynamic-ipv6:~$ docker container run my-live-alpine -it alpine /bin/ash
Unable to find image 'my-live-alpine:latest' locally
docker: Error response from daemon: pull access denied for my-live-alpine, repository does not exist or may require 'docker login': denied: requested access to the resource is denied

Run 'docker run --help' for more information
rashmika@adsl-dynamic-ipv6:~$ docker exec -it my-live-alpine /bin/ash
/ # ll
/bin/ash: ll: not found
/ # ls
bin    dev    etc    home   lib    media  mnt    opt    proc   root   run    sbin   srv    sys    tmp    usr    var
/ # exit
rashmika@adsl-dynamic-ipv6:~$ docker container run my-live-alpine -it alpine /bin/ash
Unable to find image 'my-live-alpine:latest' locally
^[[Bdocker: Error response from daemon: pull access denied for my-live-alpine, repository does not exist or may require 'docker login': denied: requested access to the resource is denied

Run 'docker run --help' for more information
rashmika@adsl-dynamic-ipv6:~$ docker container run my-live-alpine -it alpine /bin/ash
Unable to find image 'my-live-alpine:latest' locally
docker: Error response from daemon: pull access denied for my-live-alpine, repository does not exist or may require 'docker login': denied: requested access to the resource is denied

Run 'docker run --help' for more information
rashmika@adsl-dynamic-ipv6:~$ docker exec -it my-live-alpine /bin/ash
/ # ps
PID   USER     TIME  COMMAND
    1 root      0:00 /bin/ash
   42 root      0:00 /bin/ash
   48 root      0:00 ps
/ # exit
rashmika@adsl-dynamic-ipv6:~$ docker container ls
CONTAINER ID   IMAGE                  COMMAND                  CREATED          STATUS          PORTS                       NAMES
36d9acb76f5a   alpine                 "/bin/ash"               23 minutes ago   Up 23 minutes                               my-live-alpine
c6ebe07cd850   kindest/node:v1.29.2   "/usr/local/bin/entr…"   5 days ago       Up 37 minutes   127.0.0.1:33561->6443/tcp   kind-control-plane
rashmika@adsl-dynamic-ipv6:~$ docker exec -it my-live-alpine /bin/ash
/ # ls
bin    dev    etc    home   lib    media  mnt    opt    proc   root   run    sbin   srv    sys    tmp    usr    var
/ # echo "This is a sample file to test" > test.txt
/ # ls
bin       etc       lib       mnt       proc      run       srv       test.txt  usr
dev       home      media     opt       root      sbin      sys       tmp       var
/ # nano test.txt
/bin/ash: nano: not found
/ # yum test.txt
/bin/ash: yum: not found
/ # vim test.txt
/bin/ash: vim: not found
/ # cat test.txt
This is a sample file to test
/ # ls
bin       etc       lib       mnt       proc      run       srv       test.txt  usr
dev       home      media     opt       root      sbin      sys       tmp       var
/ # exit
rashmika@adsl-dynamic-ipv6:~$ docker container run --name my-fresh-alpine -dit alpine bin/sh

db2ece282699bb851f8a8af9b8673b20f9e333774b784b73f3ea16cf70172aaa
rashmika@adsl-dynamic-ipv6:~$ 
rashmika@adsl-dynamic-ipv6:~$ docker exec my-fresh-alpine -it -- /bin/sh
OCI runtime exec failed: exec failed: unable to start container process: exec: "-it": executable file not found in $PATH: unknown
rashmika@adsl-dynamic-ipv6:~$ docker exec my-fresh-alpine -it  /bin/sh
OCI runtime exec failed: exec failed: unable to start container process: exec: "-it": executable file not found in $PATH: unknown
rashmika@adsl-dynamic-ipv6:~$ docker exec -it  my-fresh-alpine  /bin/sh
/ # ls
bin    dev    etc    home   lib    media  mnt    opt    proc   root   run    sbin   srv    sys    tmp    usr    var
/ # ifconfig
eth0      Link encap:Ethernet  HWaddr 3E:50:AA:35:4C:42  
          inet addr:172.17.0.3  Bcast:172.17.255.255  Mask:255.255.0.0
          UP BROADCAST RUNNING MULTICAST  MTU:1500  Metric:1
          RX packets:22 errors:0 dropped:0 overruns:0 frame:0
          TX packets:3 errors:0 dropped:0 overruns:0 carrier:0
          collisions:0 txqueuelen:0 
          RX bytes:2980 (2.9 KiB)  TX bytes:126 (126.0 B)

lo        Link encap:Local Loopback  
          inet addr:127.0.0.1  Mask:255.0.0.0
          inet6 addr: ::1/128 Scope:Host
          UP LOOPBACK RUNNING  MTU:65536  Metric:1
          RX packets:0 errors:0 dropped:0 overruns:0 frame:0
          TX packets:0 errors:0 dropped:0 overruns:0 carrier:0
          collisions:0 txqueuelen:1000 
          RX bytes:0 (0.0 B)  TX bytes:0 (0.0 B)

/ # exit
rashmika@adsl-dynamic-ipv6:~$ docker container ls
CONTAINER ID   IMAGE                  COMMAND                  CREATED          STATUS          PORTS                       NAMES
db2ece282699   alpine                 "bin/sh"                 4 minutes ago    Up 3 minutes                                my-fresh-alpine
36d9acb76f5a   alpine                 "/bin/ash"               31 minutes ago   Up 31 minutes                               my-live-alpine
c6ebe07cd850   kindest/node:v1.29.2   "/usr/local/bin/entr…"   5 days ago       Up 45 minutes   127.0.0.1:33561->6443/tcp   kind-control-plane
rashmika@adsl-dynamic-ipv6:~$ docker container exec -it my-fresh-alpine
docker: 'docker container exec' requires at least 2 arguments

Usage:  docker container exec [OPTIONS] CONTAINER COMMAND [ARG...]

See 'docker container exec --help' for more information
rashmika@adsl-dynamic-ipv6:~$ docker container rm my-fresh-alpine
Error response from daemon: cannot remove container "my-fresh-alpine": container is running: stop the container before removing or force remove
rashmika@adsl-dynamic-ipv6:~$ docker container stop  my-fresh-alpine
my-fresh-alpine
rashmika@adsl-dynamic-ipv6:~$ docker container rm my-fresh-alpine

my-fresh-alpine
rashmika@adsl-dynamic-ipv6:~$ 
rashmika@adsl-dynamic-ipv6:~$ docker container ls
CONTAINER ID   IMAGE                  COMMAND                  CREATED          STATUS             PORTS                       NAMES
36d9acb76f5a   alpine                 "/bin/ash"               55 minutes ago   Up 55 minutes                                  my-live-alpine
c6ebe07cd850   kindest/node:v1.29.2   "/usr/local/bin/entr…"   5 days ago       Up About an hour   127.0.0.1:33561->6443/tcp   kind-control-plane
rashmika@adsl-dynamic-ipv6:~$ docker container stop  my-live-alpine
my-live-alpine
rashmika@adsl-dynamic-ipv6:~$ docker container rm my-live-alpine
my-live-alpine
rashmika@adsl-dynamic-ipv6:~$ docker container ls
CONTAINER ID   IMAGE                  COMMAND                  CREATED      STATUS             PORTS                       NAMES
c6ebe07cd850   kindest/node:v1.29.2   "/usr/local/bin/entr…"   5 days ago   Up About an hour   127.0.0.1:33561->6443/tcp   kind-control-plane
rashmika@adsl-dynamic-ipv6:~$ 